bash src/convert.sh
<ol><li> The smell coming from the dumpster was an <u>abomination</u>.</li> <li> The dictator's treatment of his citizens was an <u>abomination</u> to human rights.</li></ol> 	 <ol><li> ダンプスターから出る臭いは、<u>忌み嫌わしいもの</u>でした。</li> <li> 独裁者が市民に対する扱いは、人権に対する<u>忌み嫌わしいもの</u>でした。</li></ol> 
<ol><li> The priest <u>absolved</u> the sinner of his sins after confession.</li> <li> The court <u>absolved</u> the accused of all charges due to lack of evidence.</li></ol> 	 <ol><li> 司祭は告解後、罪人を罪から<u>解放しました</u>。</li> <li> 証拠不十分のため、裁判所は被告を<u>免罪しました</u>。</li></ol> 
<ol><li> The defendant was granted an <u>acquittal</u> due to lack of evidence.</li> <li> The lawyer argued for the <u>acquittal</u> of their client on the basis of self-defense.</li></ol> 	 <ol><li> 証拠不十分のため、被告人は<u>無罪放免</u>と裁定されました。</li> <li> 自己防衛の理由に基づいて、弁護士はクライアントの<u>無罪放免</u>を主張しました。</li></ol> 
<ol><li> The judge will <u>adjudicate</u> the case and make a final ruling.</li> <li> The arbitration panel was brought in to <u>adjudicate</u> the dispute between the two parties.</li></ol> 	 <ol><li> 裁判官が事件を<u>審理</u>し、最終判決を下します。</li> <li> 仲裁委員会が呼び出され、2つの当事者間の紛争を<u>仲裁</u>するために入ってきました。</li></ol> 
<ol><li> With great <u>alacrity</u>, she accepted the new job offer.</li> <li> The firefighter sprang into action with <u>alacrity</u> when the alarm went off.</li></ol> 	 <ol><li> 彼女は大きな<u>意欲</u>を持って、新しい仕事の申し出を受け入れた。</li> <li> 消防士はアラームが鳴った瞬間に<u>迅速に</u>行動した。</li></ol> 
<ol><li> The <u>amity</u> between the two nations was evident during the peace talks.</li> <li> The company's culture fosters <u>amity</u> and cooperation among its employees.</li></ol> 	 <ol><li> 平和交渉中に、二国間の<u>友好関係</u>は明らかでした。</li> <li> その企業の文化は、従業員間の<u>友好</u>や協力を育むようになっています。</li></ol> 
<ol><li> He didn't want to <u>antagonize</u> his boss by arguing with him about the project.</li> <li> The politician made a controversial statement, knowing it would <u>antagonize</u> some of his constituents.</li></ol> 	 <ol><li> 彼はプロジェクトについて上司と口論して<u>敵意を買う</u>ことを避けたかった。</li> <li> 政治家は、自分の有権者の中に<u>反感を抱かせる</u>と知りながら、物議をかもす発言をした。</li></ol> 
<ol><li> The book contained <u>arcane</u> knowledge that had been lost for centuries.</li> <li> The magician's tricks were based on <u>arcane</u> rituals passed down through generations.</li></ol> 	 <ol><li> その本には何世紀も失われていた<u>秘術的</u>な知識が含まれていました。</li> <li> 魔術師のトリックは、世代から世代に伝えられた<u>神秘的</u>な儀式に基づいていた。</li></ol> 
<ol><li> The language used in the ancient text is <u>archaic</u> and difficult to understand.</li> <li> The old castle was filled with <u>archaic</u> furniture and decorations.</li></ol> 	 <ol><li> 古代のテキストに使われている言葉は<u>古語</u>で、理解するのが難しいです。</li> <li> 古い城には<u>時代遅れの</u>家具や装飾品がいっぱいでした。</li></ol> 
<ol><li> She was assiduous in her studies, spending countless hours pouring over books and notes.</li> <li> His assiduous attention to detail was evident in the impeccable work he produced.</li></ol> 	 <ol><li> 彼女は勉強に熱心で、何時間も本やノートを見て過ごしました。</li> <li> 彼の細心の注意は、完成度の高い仕事に表れていました。</li></ol> 
<ol><li> The magician's performance <u>astounded</u> the audience with its incredible illusions.</li> <li> The beautiful scenery of the mountains never fails to <u>astound</u> me.</li></ol> 	 <ol><li> 魔術師のパフォーマンスは信じられない魔法で観客を<u>驚かせました</u>。</li> <li> 山々の美しい景色は私をいつも<u>驚かせます</u>。</li></ol> 
<ol><li> His speech was so <u>banal</u> that most of the audience fell asleep.</li> <li> I'm tired of reading <u>banal</u> love stories with predictable endings.</li></ol> 	 <ol><li> 彼のスピーチはとても<u>平凡</u>で、聴衆のほとんどが眠ってしまいました。</li> <li> 予測可能な結末を持つ<u>平凡</u>な恋愛小説を読むのに飽きました。</li></ol> 
<ol><li> The generous billionaire donated <u>benevolently</u> to multiple charities.</li> <li> She looked at him <u>benevolently</u>, knowing he had made a mistake but choosing to forgive him.</li></ol> 	 <ol><li> 誠実な億万長者は多くの慈善団体に<u>寛大に</u>寄付を行いました。</li> <li> 彼女は彼を<u>親切に</u>見つめ、彼が間違いをしたことを知っていたが、彼を許した。</li></ol> 
<ol><li> The harvest this year was bountiful, with plenty of fruits and vegetables to last my family all winter.</li> <li> The generous donor made a bountiful contribution to the charity, allowing them to continue helping people in need.</li></ol> 	 <ol><li> 今年の収穫は豊かで、家族が冬季すべて食べ物を持ち続けるだけの十分な果物や野菜がありました。</li> <li> 寛大な寄贈者が慈善団体に豊富な貢献をし、困っている人々を助け続けることができました。</li></ol> 
<ol><li> The bar erupted into a <u>brawl</u> after a disagreement between two customers.</li> <li> The hockey players got into a <u>brawl</u> on the rink during the game.</li></ol> 	 <ol><li> 2人の客間での意見の不一致により、バーで<u>もみ合い</u>が勃発した。</li> <li> ホッケー選手たちは試合中にリンクで<u>乱闘</u>になった。</li></ol> 
<ol><li> The <u>bucolic</u> scenery of the countryside made me feel peaceful.</li> <li> We enjoyed a <u>bucolic</u> picnic in the meadow surrounded by wildflowers.</li></ol> 	 <ol><li> 田舎の自然の中の<u>のどかな</u>景色が私を落ち着かせました。</li> <li> 野の花に囲まれた草地で<u>のどかな</u>ピクニックを楽しんだ。</li></ol> 
<ol><li> The political <u>caricature</u> in the newspaper was quite amusing.</li> <li> The artist created a <u>caricature</u> of the famous celebrity.</li></ol> 	 <ol><li> 新聞に載った政治の<u>風刺画</u>はとても面白かったです。</li> <li> アーティストは有名なセレブの<u>風刺画</u>を作りました。</li></ol> 
<ol><li> The senator faced <u>censure</u> from her colleagues after making controversial comments.</li> <li> The teacher received a <u>censure</u> from the school board for inappropriate behavior in the classroom.</li></ol> 	 <ol><li> 参議院議員は、物議をかもす発言をしたことで同僚から<u>非難</u>を受けました。</li> <li> 教師は、授業中の不適切な行動に対して学校委員会から<u>戒告</u>を受けました。</li></ol> 
<ol><li> She gently tried to <u>coax</u> the shy child out of his shell.</li> <li> The trainer used a treat to <u>coax</u> the dog into performing the new trick.</li></ol> 	 <ol><li> 彼女はそっと内気な子供を誘い出そうとしました。</li> <li> トレーナーはおやつを使って犬を新しいトリックをするように<u>説得しました</u>。</li></ol> 
<ol><li> There was a lot of <u>commotion</u> outside the stadium after the game ended.</li> <li> The sudden <u>commotion</u> in the classroom made it difficult for the teacher to continue the lesson.</li></ol> 	 <ol><li> 試合が終わった後、スタジアムの外で多くの<u>騒ぎ</u>がありました。</li> <li> 教室での突然の<u>騒ぎ</u>が、先生が授業を続けるのを困難にしました。</li></ol> 
<ol><li> She decided to <u>concoct</u> a plan to surprise her husband on their anniversary.</li> <li> The chef will <u>concoct</u> a special dish for tonight's menu.</li></ol> 	 <ol><li> 彼女は結婚記念日に夫を驚かす計画を<u>考案</u>することに決めました。</li> <li> シェフは今夜のメニューに特別な料理を<u>編み出す</u>予定です。</li></ol> 
<ol><li> A quiet atmosphere is <u>conducive</u> to studying.</li> <li> This room's layout is <u>conducive</u> to hosting large parties.</li></ol> 	 <ol><li> 静かな雰囲気は勉強に<u>適しています</u>。</li> <li> この部屋のレイアウトは大規模なパーティーに<u>適しています</u>。</li></ol> 
<ol><li> The forest fire turned into a massive <u>conflagration</u>, spreading across several acres of land.</li> <li> The riots escalated into a dangerous <u>conflagration</u>, resulting in destruction of public property.</li></ol> 	 <ol><li> 森林火災は大量の土地に広がる<u>大規模な火災</u>になりました。</li> <li> 暴動が危険な<u>大規模な火災</u>にエスカレートし、公共財産が破壊されました。</li></ol> 
<ol><li> The birds will <u>congregate</u> in the park during the winter months.</li> <li> The protesters plan to <u>congregate</u> in front of City Hall tomorrow.</li></ol> 	 <ol><li> 冬の間、鳥たちは公園で<u>群れを成す</u>でしょう。</li> <li> 抗議者たちは明日市庁舎の前に<u>集まる</u>予定です。</li></ol> 
<ol><li> The queen was seen with her <u>consort</u> at the ball.</li> <li> The musician collaborated with a well-known <u>consort</u> in his latest album.</li></ol> 	 <ol><li> 女王はダンスパーティーで彼女の<u>配偶者</u>と一緒に見られました。</li> <li> ミュージシャンは、彼の最新アルバムで有名な<u>協奏者</u>とコラボレーションしました。</li></ol> 
<ol><li> The artist's <u>consummate</u> skill is evident in every brushstroke of the painting.</li> <li> The <u>consummate</u> professionalism of the surgeon ensured a successful operation.</li></ol> 	 <ol><li> 画家の<u>卓越した</u>技術が、絵画の一つ一つの筆遣いに表れています。</li> <li> 外科医の<u>完全な</u>プロフェッショナリズムによって、手術は成功裏に終わりました。</li></ol> 
<ol><li> We have a <u>contingency</u> plan in case the weather disrupts our outdoor event.</li> <li> The company's <u>contingency</u> fund is intended for unexpected expenses.</li></ol> 	 <ol><li> 天気が屋外イベントを中断する場合、<u>万が一の</u>計画があります。</li> <li> 会社の<u>非常事態</u>基金は予期せぬ出費のために用意されています。</li></ol> 
<ol><li> It is illegal to bring <u>contraband</u> items into the country.</li> <li> The police found a bag of <u>contraband</u> drugs in the suspect's car.</li></ol> 	 <ol><li> 国に<u>密輸品</u>を持ち込むことは違法です。</li> <li> 警察は容疑者の車の中に<u>密輸品</u>の麻薬を見つけました。</li></ol> 
<ol><li> The company provided a <u>conveyance</u> for the employees to get to the offsite meeting.</li> <li> The horses were used as a <u>conveyance</u> for transportation in medieval times.</li></ol> 	 <ol><li> 会社は社員がオフサイトミーティングに行くための<u>乗り物</u>を提供しました。</li> <li> 中世には、馬が<u>移動手段</u>として使用されていました。</li></ol> 
<ol><li> The project's <u>culmination</u> was a successful product launch.</li> <li> Years of hard work led to the <u>culmination</u> of her dream of becoming a doctor.</li></ol> 	 <ol><li> そのプロジェクトの<u>クライマックス</u>は、成功した製品ローンチでした。</li> <li> 長年の努力が実った結果、彼女の医師になるという夢が<u>実現</u>しました。</li></ol> 
<ol><li> The keys to the car were left inside and <u>dangle</u>d from the ignition.</li> <li> She leaned over the bridge and let her feet <u>dangle</u> in the water below.</li></ol> 	 <ol><li> 車の鍵は中に残され、イグニッションから<u>ぶら下がって</u>いました。</li> <li> 彼女は橋に身を乗り出して、足を下に<u>ぶら下げました</u>。</li></ol> 
<ol><li> Please don't <u>dawdle</u> on your way to school or you'll be late.</li> <li> We can't <u>dawdle</u> any longer, we need to start working on this project.</li></ol> 	 <ol><li> 学校までの道で<u>ぐずぐず</u>しないでください。遅刻しちゃいますよ。</li> <li> もう<u>ぐずぐず</u>できない。このプロジェクトに取り掛からなくちゃ。</li></ol> 
<ol><li> There is a <u>dearth</u> of food supplies in this famine-stricken region.</li> <li> The <u>dearth</u> of rain has resulted in drought across the country.</li></ol> 	 <ol><li> この飢餓に苦しむ地域では食料の<u>不足</u>があります。</li> <li> <u>不足</u>した雨は全国的に干ばつを引き起こしました。</li></ol> 
<ol><li> The cruel ruler sought to <u>debase</u> his political enemies by spreading false rumors and lies.</li> <li> The counterfeit goods sold at the market <u>debase</u> the reputation of the genuine products.</li></ol> 	 <ol><li> 残酷な支配者は、虚偽の噂や嘘を広めることによって政治的な敵を<u>貶めよう</u>としました。</li> <li> 市場で販売されている偽物の商品は、本物の製品の評判を<u>低下させます</u>。</li></ol> 
<ol><li> The <u>deceased</u> left behind a will detailing how their assets should be distributed.</li> <li> The family mourned the loss of their <u>deceased</u> loved one at the funeral.</li></ol> 	 <ol><li> <u>故人</u>は遺言を残し、自分の資産の配分を詳しく記載しています。</li> <li> 家族は葬儀で亡くなった<u>故人</u>を悼みました。</li></ol> 
<ol><li> The <u>decorum</u> of a wedding ceremony requires guests to dress formally.</li> <li> The professor was known for his strict adherence to <u>decorum</u> in the classroom.</li></ol> 	 <ol><li> 結婚式の<u>儀礼</u>には、ゲストはフォーマルな服装である必要があります。</li> <li> 教授は授業中の<u>礼儀正しさ</u>に厳格で知られていました。</li></ol> 
<ol><li> The king issued a <u>decree</u> that all citizens must pay taxes.</li> <li> The company's <u>decree</u> was that all employees must wear formal attire to work.</li></ol> 	 <ol><li> 王様は、すべての市民が税金を支払わなければならないという<u>布告</u>を発した。</li> <li> その会社の<u>規定</u>は、すべての従業員が勤務時に正式な服装を着用しなければならないことでした。</li></ol> 
<ol><li> By analyzing the data, we can <u>deduce</u> that the sales have been steadily increasing.</li> <li> Based on the evidence, the detective was able to <u>deduce</u> who the culprit was.</li></ol> 	 <ol><li> データを分析することによって、売上が着実に増加していることが<u>推測</u>できます。</li> <li> 証拠に基づいて、刑事は犯人が誰かを<u>推理</u>することができました。</li></ol> 
<ol><li> The graffiti artist was caught attempting to <u>deface</u> the building's walls.</li> <li> Vandalism is a serious crime that can result in fines or imprisonment for those who <u>deface</u> public property.</li></ol> 	 <ol><li> グラフィティアーティストは、建物の壁を<u>汚す</u>試みで捕まえられました。</li> <li> 破壊行為は公共物を<u>汚す</u>人に罰金または投獄の結果をもたらす重大な犯罪です。</li></ol> 
<ol><li> The students showed <u>defiance</u> by protesting against the new school policy.</li> <li> The rebel leader stared at the enemy army with <u>defiance</u> in his eyes.</li></ol> 	 <ol><li> 生徒たちは新しい学校の方針に抗議して<u>反抗</u>を示しました。</li> <li> 反乱軍のリーダーは敵軍を見つめ、目に<u>反抗心</u>を宿らせました。</li></ol> 
<ol><li> Many ancient civilizations believed in multiple <u>deities</u>, each with their own powers and responsibilities.</li> <li> The temple was built to honor a <u>deity</u> of fertility and harvest.</li></ol> 	 <ol><li> 多くの古代文明は、それぞれに固有の力と責任を持つ複数の<u>神々</u>を信じていました。</li> <li> 寺院は、豊穣と収穫の<u>神</u>を讃えるために建てられました。</li></ol> 
<ol><li> His belief that he could fly was a <u>delusion</u>.</li> <li> She was suffering from a <u>delusion</u> that everyone was out to get her.</li></ol> 	 <ol><li> 彼が飛べると信じるのは<u>妄想</u>だった。</li> <li> 彼女は、誰もが彼女を狙っているという<u>妄想</u>に苦しんでいた。</li></ol> 
<ol><li> Let's <u>delve</u> deeper into the issue to find a solution.</li> <li> The archaeologists plan to <u>delve</u> into the ruins to uncover hidden artifacts.</li></ol> 	 <ol><li> 解決策を見つけるために問題に<u>掘り下げ</u>ましょう。</li> <li> 考古学者たちは隠れた遺物を見つけるために遺跡に<u>掘り下げ</u>る予定です。</li></ol> 
<ol><li> His calm and collected <u>demeanor</u> helped diffuse the tense situation.</li> <li> Despite the stress of the job, the nurse maintained a professional <u>demeanor</u> with patients.</li></ol> 	 <ol><li> 彼の冷静で落ち着いた<u>態度</u>が、緊張した状況を鎮めるのを助けました。</li> <li> 仕事のストレスにもかかわらず、看護師は患者に対してプロの<u>態度</u>を保ちました。</li></ol> 
<ol><li> The letter "P" <u>denotes</u> the sound made by the letter in the word "pineapple".</li> <li> In chess, a pawn <u>denotes</u> the smallest piece on the board.</li></ol> 	 <ol><li> 「P」の文字は「パイナップル」という単語での音を<u>示します</u>。</li> <li> チェスでは、ポーンはボード上で最も小さい駒を<u>表します</u>。</li></ol> 
<ol><li> The conditions in the refugee camps were <u>deplorable</u>.</li> <li> The treatment of the workers was <u>deplorable</u> and led to protests.</li></ol> 	 <ol><li> 難民キャンプの状況は<u>悲惨な</u>ものでした。</li> <li> 従業員の扱いが<u>ひどく</u>、抗議を引き起こしました。</li></ol> 
<ol><li> The boss always tries to <u>deprecate</u> my ideas in meetings.</li> <li> We should never <u>deprecate</u> someone's achievements, no matter how small they may seem.</li></ol> 	 <ol><li> 上司はいつもミーティングで私のアイデアを<u>貶めようとする</u>。</li> <li> 誰かの成果を<u>見くびる</u>ことは、どんなに小さく見えても、決してしてはいけません。</li></ol> 
<ol><li> The comedian's joke was met with <u>derision</u> from the audience.</li> <li> The manager's idea was met with <u>derision</u> from the team members.</li></ol> 	 <ol><li> コメディアンのジョークは聴衆から<u>嘲笑</u>を浴びた。</li> <li> マネージャーのアイデアはチームメンバーから<u>ばかにされた</u>。</li></ol> 
<ol><li> Using <u>derogatory</u> language towards someone is not acceptable in a professional setting.</li> <li> The article's <u>derogatory</u> tone towards immigrants sparked controversy.</li></ol> 	 <ol><li> プロの場では誰かに<u>軽蔑的な</u>言葉を使うことは許されません。</li> <li> その記事の移民に対する<u>侮蔑的な</u>トーンが論争を引き起こしました。</li></ol> 
<ol><li> Many people in the town are <u>destitute</u> and in need of assistance. </li> <li> After losing his job and home, he became completely <u>destitute</u>.</li></ol> 	 <ol><li> その街の多くの人が<u>破産状態</u>で援助を必要としています。</li> <li> 彼は仕事と家を失って完全に<u>破産状態</u>になりました。</li></ol> 
<ol><li> The old house was <u>devoid</u> of modern amenities, such as air conditioning and Wi-Fi.</li> <li> The painting was <u>devoid</u> of color, with only shades of black and white.</li></ol> 	 <ol><li> 古い家はエアコンやWi-Fiなどの現代的な設備が<u>欠如していました</u>。</li> <li> 絵は、黒と白の濃淡しかなく、色が<u>なかった</u>。</li></ol> 
<ol><li> She was a <u>devout</u> Catholic and attended church every Sunday.</li> <li> The <u>devout</u> monk spent most of his days in meditation and prayer.</li></ol> 	 <ol><li> 彼女は熱心なカトリック信者で、毎週日曜日に教会に通っていました。</li> <li> 熱心な僧侶は、ほとんどの時間を瞑想や祈りに費やしていました。</li></ol> 
<ol><li> The lazy student showed up to class with <u>disheveled</u> hair and wrinkled clothes.</li> <li> After the party, the living room was left in a <u>disheveled</u> mess.</li></ol> 	 <ol><li> 怠惰な学生は、<u>だらしなく</u>絡まった髪としわくちゃの服で授業に現れました。</li> <li> パーティーの後、リビングルームは<u>だらしなく</u>散らかっていました。</li></ol> 
<ol><li> The strong wind managed to <u>dislodge</u> a shingle from the roof.</li> <li> The dentist had to <u>dislodge</u> a piece of food stuck between my teeth.</li></ol> 	 <ol><li> 強い風が屋根の瓦を<u>はずす</u>ことに成功しました。</li> <li> 歯医者は私の歯の間に挟まった食べ物を<u>取り除く</u>必要がありました。</li></ol> 
<ol><li> The teacher tried to <u>dispel</u> the student's misunderstanding about the subject.</li> <li> A glass of warm milk before bed can help <u>dispel</u> insomnia.</li></ol> 	 <ol><li> 先生は、生徒の科目に関する誤解を<u>解消</u>しようとしました。</li> <li> 就寝前に温かいミルクを飲むと、不眠症を<u>解消</u>するのに役立ちます。</li></ol> 
<ol><li> Mary has a cheerful <u>disposition</u> and always sees the bright side of things.</li> <li> The company values employees with a positive <u>disposition</u> and strong work ethic.</li></ol> 	 <ol><li> メアリーは陽気な<u>気質</u>を持ち、常に物事の明るい面を見ます。</li> <li> 会社は、ポジティブな<u>気質</u>と強い職業意識を持つ従業員を大切にします。</li></ol> 
<ol><li> My dissertation topic is on the effects of social media on mental health.</li> <li> I've been working on my dissertation for months now and it's finally coming together.</li></ol> 	 <ol><li> 私の博士論文のトピックは、ソーシャルメディアが精神衛生に与える影響です。</li> <li> 私は数ヶ月間博士論文に取り組んできましたが、ようやくまとまりつつあります。</li></ol> 
<ol><li> After eating too much, his stomach began to <u>distend</u> uncomfortably.</li> <li> The balloon started to <u>distend</u> as more and more air was blown into it.</li></ol> 	 <ol><li> 食べ過ぎた後、彼の胃は不快に<u>膨らみました</u>。</li> <li> 空気を吹き込むと、風船は<u>膨張し始めました</u>。</li></ol> 
<ol><li> The volcano has been <u>dormant</u> for hundreds of years, but it could still erupt at any time.</li> <li> The company had a <u>dormant</u> period during the recession, but now they are thriving again.</li></ol> 	 <ol><li> 数百年にわたってその火山は<u>活動休止</u>状態でしたが、いつ噴火してもおかしくありません。</li> <li> その会社は不況時に<u>休眠期間</u>がありましたが、今は再び繁栄しています。</li></ol> 
<ol><li> The city in winter can look very <u>drab</u> with grey skies and bare trees.</li> <li> The office was painted in <u>drab</u> colors to create a serious atmosphere.</li></ol> 	 <ol><li> 冬の街は灰色の空と裸の木々でとても<u>冴えない</u>様子に見えます。</li> <li> オフィスは真面目な雰囲気を作るために<u>地味な</u>色で塗られました。</li></ol> 
<ol><li> The dreary weather made everyone feel sad and gloomy.</li> <li> The abandoned house looked old and dreary.</li></ol> 	 <ol><li> 暗くてどんよりした天気は、皆を悲しくさせました。</li> <li> 放棄された家は古くて陰気でした。</li></ol> 
<ol><li> I got caught in the rain and was completely <u>drenched</u> by the time I got home.</li> <li> The water ride at the amusement park was so intense that we all got <u>drenched</u>.</li></ol> 	 <ol><li> 雨に降られて帰宅するまで完全に<u>ずぶ濡れ</u>になりました。</li> <li> 遊園地のウォーターライドはとても激しかったので、私たちは皆<u>びしょ濡れ</u>になりました。</li></ol> 
<ol><li> The politician's <u>duplicity</u> was exposed when he was caught lying to both sides of the argument.</li> <li> The spy's <u>duplicity</u> nearly jeopardized the entire mission.</li></ol> 	 <ol><li> 政治家の<u>二枚舌</u>は、彼が議論の両側面に嘘をついているのが発覚したときに暴かれた。</li> <li> スパイの<u>不誠実さ</u>は、任務全体を危うくしかねなかった。</li></ol> 
<ol><li> The children were <u>ecstatic</u> when they found out they were going to Disneyland.</li> <li> She was <u>ecstatic</u> when she got accepted into her dream college.</li></ol> 	 <ol><li> 子供たちはディズニーランドに行くことがわかったとき、<u>大喜び</u>でした。</li> <li> 彼女は夢の大学に合格したとき、<u>大喜び</u>でした。</li></ol> 
<ol><li> The new vaccine has proven to be quite <u>efficacious</u> in preventing the spread of the virus.</li> <li> The therapist recommended an <u>efficacious</u> treatment plan for managing anxiety.</li></ol> 	 <ol><li> 新しいワクチンはウイルスの拡散を防ぐのにかなり<u>効果的</u>であることが証明されています。</li> <li> セラピストは、不安を管理するための<u>有効な</u>治療計画を勧めました。</li></ol> 
<ol><li> The public speaking coach taught the students about proper <u>elocution</u> for effective communication.</li> <li> The politician's impeccable <u>elocution</u> skills helped him win over the crowd during his campaign rallies.</li></ol> 	 <ol><li> 公演コーチは、効果的なコミュニケーションのための適切な<u>朗読法</u>について生徒たちに教えました。</li> <li> 政治家の完璧な<u>朗読法</u>スキルは、キャンペーン集会で群衆を魅了するのに役立ちました。</li></ol> 
<ol><li> The answer to the puzzle continues to <u>elude</u> me, even after several attempts.</li> <li> Despite their best efforts, the police were unable to <u>elude</u> the suspect during the chase.</li></ol> 	 <ol><li> パズルの答えは何度も試してみたけれど、未だに<u>見つけられない</u>。</li> <li> 最善の努力にもかかわらず、警察は追跡中に容疑者を<u>振り切ることができなかった</u>。</li></ol> 
<ol><li> The coat of arms on the wall is <u>emblazoned</u> with the family motto.</li> <li> The superhero's emblem is <u>emblazoned</u> on his chest, identifying him to the world.</li></ol> 	 <ol><li> 壁に掛かっている紋章は家族のモットーで<u>飾られ</u>ています。</li> <li> スーパーヒーローのエンブレムは胸に<u>刻まれ</u>、彼を世界に識別します。</li></ol> 
<ol><li> My great-grandparents <u>emigrated</u> from Italy to America during the early 1900s.</li> <li> Many people <u>emigrate</u> to other countries in search of better job opportunities and living conditions.</li></ol> 	 <ol><li> 1900年代初頭に私の曽祖父母はイタリアからアメリカに<u>移住</u>しました。</li> <li> 多くの人々がより良い仕事と生活環境を求めて他国に<u>移住</u>します。</li></ol> 
<ol><li> The scientist's <u>eminence</u> in the field of genetics earned him international recognition.</li> <li> The new restaurant has become a popular spot due to the <u>eminence</u> of its chef.</li></ol> 	 <ol><li> 遺伝学の分野での科学者の<u>卓越性</u>が国際的な認知を得ました。</li> <li> 新しいレストランのシェフの<u>卓越性</u>が人気の理由となっています。</li></ol> 
<ol><li> The coach's <u>emphatic</u> speech inspired the team to win the championship.</li> <li> She spoke with such <u>emphatic</u> confidence that nobody could doubt her expertise.</li></ol> 	 <ol><li> コーチの<u>力強い</u>スピーチがチームを勝利へと導きました。</li> <li> 彼女は<u>強い口調で</u>話し、誰も彼女の専門知識を疑うことはできませんでした。</li></ol> 
<ol><li> It is important to <u>encrypt</u> your sensitive information to protect it from hackers.</li> <li> The company uses a complex algorithm to <u>encrypt</u> their customers' private data.</li></ol> 	 <ol><li> ハッカーから情報を守るために、重要な情報を<u>暗号化</u>することが重要です。</li> <li> その会社は、顧客のプライベートデータを<u>暗号化</u>するために複雑なアルゴリズムを使用しています。</li></ol> 
<ol><li> The hurricane is expected to <u>engulf</u> the entire coastal region.</li> <li> He couldn't escape the flames as they <u>engulfed</u> his house.</li></ol> 	 <ol><li> ハリケーンは、沿岸地域全体を<u>飲み込む</u>と予想されています。</li> <li> 彼は自宅が炎に<u>飲み込ま</u>れるのを逃れることができませんでした。</li></ol> 
<ol><li> The stock market has been <u>erratic</u> lately, with unpredictable fluctuations.</li> <li> His behavior can be quite <u>erratic</u>, one moment he's happy and the next he's angry.</li></ol> 	 <ol><li> 最近、株式市場は予測がつかない変動が<u>不安定</u>でした。</li> <li> 彼の振る舞いはかなり<u>不規則</u>で、一瞬幸せそうで、次の瞬間には怒っています。</li></ol> 
<ol><li> The man gave a heartfelt <u>eulogy</u> at his friend's funeral.</li> <li> Writing a <u>eulogy</u> for her father was one of the hardest things she had ever done.</li></ol> 	 <ol><li> 男性は友人の葬式で心からの<u>弔辞</u>を述べました。</li> <li> 父親のために<u>弔辞</u>を書くことは、彼女が今まで経験した中で最も難しいことの1つでした。</li></ol> 
<ol><li> The landlord decided to <u>evict</u> the tenants for not paying rent.</li> <li> The homeowner was legally allowed to <u>evict</u> the squatters from their property.</li></ol> 	 <ol><li> 家賃を払わなかったため、家主は入居者を<u>立ち退かせる</u>ことに決めました。</li> <li> 不法侵入者を<u>排除する</u>ため、家の所有者は法的にその権利を持っていました。</li></ol> 
<ol><li> The old photograph of her grandparents always <u>evokes</u> happy memories for her.</li> <li> The song <u>evokes</u> feelings of nostalgia for his childhood.</li></ol> 	 <ol><li> 彼女の祖父母の古い写真はいつも彼女に幸せな思い出を<u>呼び起こさせます</u>。</li> <li> その曲は彼の子供時代に対する懐かしさを<u>引き起こします</u>。</li></ol> 
<ol><li> The population of the city has been growing <u>exponentially</u> in the past decade.</li> <li> The company's profits have been increasing <u>exponentially</u> since they introduced their new product.</li></ol> 	 <ol><li> この10年間、その都市の人口は<u>指数関数的に</u>増加しています。</li> <li> 新製品を導入してから、その会社の利益は<u>急激に</u>増加しています。</li></ol> 
<ol><li> The diamond has many <u>facets</u>, each reflecting the light in a different way.</li> <li> The issue has many <u>facets</u>, and we need to consider them all before making a decision.</li></ol> 	 <ol><li> ダイヤモンドには多くの<u>面</u>があり、それぞれ異なる角度で光を反射します。</li> <li> 問題には多くの<u>側面</u>があり、決定を下す前にすべてを考慮する必要があります。</li></ol> 
<ol><li> His comment was just <u>facetious</u>, but it still offended some people.</li> <li> I always have a hard time telling if he's being serious or just <u>facetious</u>.</li></ol> 	 <ol><li> 彼のコメントは単なる<u>ふざけた</u>ものだったが、それでもいくつかの人々を怒らせた。</li> <li> 彼が真剣なのか、ただ<u>ふざけている</u>のかを判断するのはいつも難しい。</li></ol> 
<ol><li> It is a <u>fallacy</u> that success can only be achieved through working long hours.</li> <li> The politician's argument is based on a <u>fallacy</u> that all immigrants are criminals.</li></ol> 	 <ol><li> 長時間働くしか成功を収められない、というのは<u>誤り</u>です。</li> <li> 政治家の主張は、すべての移民が犯罪者であるという<u>論理の誤り</u>に基づいています。</li></ol> 
<ol><li> His argument is <u>fallible</u> because it is based on false assumptions.</li> <li> As humans, we are <u>fallible</u> and make mistakes from time to time.</li></ol> 	 <ol><li> 彼の主張は誤った前提に基づいているため、<u>誤りやすい</u>ものです。</li> <li> 人間として、私たちは<u>誤りやすい</u>存在であり、時には間違いを comすることがあります。</li></ol> 
<ol><li> The prisoner felt trapped by the <u>fetters</u> on his ankles.</li> <li> The new policy has been a <u>fetter</u> on the company's growth.</li></ol> 	 <ol><li> 囚人は足首に<u>足かせ</u>を感じていました。</li> <li> 新しい方針は企業の成長に<u>拘束</u>となっています。</li></ol> 
<ol><li> The couple's <u>fidelity</u> to each other was unshakeable, even in the face of temptation.</li> <li> The audio equipment was praised for its <u>fidelity</u> to the original sound recording.</li></ol> 	 <ol><li> カップルの<u>貞節</u>は、誘惑に直面しても揺るぎなかった。</li> <li> 音声設備は、オリジナルの音声録音に<u>忠実</u>であると評価されました。</li></ol> 
<ol><li> The athlete's <u>flagrant</u> violation of the rules led to his disqualification from the competition.</li> <li> The company's <u>flagrant</u> disregard for safety regulations resulted in a serious accident.</li></ol> 	 <ol><li> その選手のルール違反は<u>明白な</u>もので、競技からの失格につながりました。</li> <li> その企業の安全規制に対する<u>明白な</u>無視が、重大な事故につながりました。</li></ol> 
<ol><li> The tent was so <u>flimsy</u> that it ripped in the wind.</li> <li> I wouldn't trust that ladder, it looks <u>flimsy</u>.</li></ol> 	 <ol><li> テントが風で破れたのは、あまりにも<u>薄っぺらい</u>素材だからです。</li> <li> あのはしごには、信頼できない。とっても<u>ぐらついている</u>よ。</li></ol> 
<ol><li> The <u>foliage</u> in Central Park is especially beautiful in the fall.</li> <li> She collected some bright red <u>foliage</u> to use as decorations for Thanksgiving.</li></ol> 	 <ol><li> 中央公園の<u>葉</u>は秋に特に美しいです。</li> <li> 彼女は明るい赤い<u>葉っぱ</u>を集め、感謝祭の装飾に使いました。</li></ol> 
<ol><li> She lived a <u>frugal</u> life, saving every penny she could.</li> <li> My grandfather is very <u>frugal</u> and always tries to find the best deals.</li></ol> 	 <ol><li> 彼女は貧乏暮らしをし、できる限りのお金を節約していました。</li> <li> 私のおじいちゃんはとても<b>倹約家</b>で、常に最高の取引を見つけようとします。</li></ol> 
<ol><li> The message was <u>garbled</u> and hard to understand.</li> <li> The phone connection was <u>garbled</u> and we had to call back.</li></ol> 	 <ol><li> そのメッセージは<u>難解な</u>ため、理解するのが難しかったです。</li> <li> 電話の接続が<u>不明瞭だった</u>ため、折り返し電話をしなければなりませんでした。</li></ol> 
<ol><li> The dress she wore to the party was too <u>gaudy</u> for my taste.</li> <li> The new building in the city center is decorated with <u>gaudy</u> neon signs.</li></ol> 	 <ol><li> 彼女がパーティーで着ていたドレスは私の好みに合わないくらい派手でした。</li> <li> 街の中心に建設された新しい建物は、<u>派手な</u>ネオンサインで飾られています。</li></ol> 
<ol><li> The hiker marveled at the natural <u>gorge</u> created by the river cutting through the rocks.</li> <li> She lost her balance and fell into the <u>gorge</u>, luckily only sustaining minor injuries.</li></ol> 	 <ol><li> ハイカーは、川が岩を切り抜いた自然の<u>渓谷</u>に驚嘆した。</li> <li> 彼女はバランスを崩して<u>渓谷</u>に落ち、幸いにも軽傷ですんだ。</li></ol> 
<ol><li> The <u>gradient</u> of the mountain path was so steep, it was difficult to climb.</li> <li> The artist used a <u>gradient</u> of blue shades to create a beautiful painting of the ocean.</li></ol> 	 <ol><li> 山道の<u>勾配</u>が非常に急だったため、登るのが難しかった。</li> <li> 画家は、青色の<u>グラデーション</u>を使用して美しい海の絵を描きました。</li></ol> 
<ol><li> The surgeon performed a <u>graft</u> to repair the damaged tissue.</li> <li> The gardener <u>grafted</u> different types of roses together to create a hybrid plant.</li></ol> 	 <ol><li> 外科医は傷ついた組織を修復するために<u>移植手術</u>を実施しました。</li> <li> 庭師は異なる種類のバラを<u>接ぎ木</u>してハイブリッド植物を作り出しました。</li></ol> 
<ol><li> The wrestler tried to <u>grapple</u> his opponent to the mat.</li> <li> The team had to <u>grapple</u> with difficult decisions during the game.</li></ol> 	 <ol><li> レスラーは相手をマットに<u>押し倒す</u>ために努力しました。</li> <li> チームは試合中に難しい決断に<u>取り組まなければならなかった</u>。</li></ol> 
<ol><li> Running a marathon can be a <u>grueling</u> experience, both physically and mentally.</li> <li> The contestants had to endure a <u>grueling</u> obstacle course in order to win the prize.</li></ol> 	 <ol><li> マラソンを走ることは、身体的にも精神的にも<u>過酷な</u>経験になることがあります。</li> <li> 参加者は、賞金を手にするために<u>過酷な</u>障害コースを耐え忍ばなければならなかった。</li></ol> 
<ol><li> The party goers continued to <u>guzzle</u> beer long after midnight.</li> <li> He tends to <u>guzzle</u> soda whenever he's feeling thirsty.</li></ol> 	 <ol><li> パーティーの参加者たちは深夜を過ぎてもビールを<u>がぶ飲み</u>していました。</li> <li> 彼は喉が渇いた時にはいつでもソーダを<u>ぐいぐい</u>飲む傾向があります。</li></ol> 
<ol><li> Her <u>haughty</u> attitude made it difficult for anyone to approach her. </li> <li> The CEO's <u>haughty</u> behavior towards his employees caused many to quit. </li></ol> 	 <ol><li> 彼女の<u>高慢な</u>態度が、誰も彼女に近づけないようにした。 </li> <li> CEOの社員に対する<u>傲慢な</u>態度は、多くの人が辞める原因となった。 </li></ol> 
<ol><li> <u>Hereditary</u> diseases can be passed down through generations in a family.</li> <li> The king's crown is a <u>hereditary</u> item that has been passed down for centuries.</li></ol> 	 <ol><li> <u>遺伝的</u>疾患は、家族の間で世代を超えて受け継がれることがあります。</li> <li> 王の王冠は、何世紀にもわたって受け継がれてきた<u>世襲の</u>品です。</li></ol> 
<ol><li> The movie director paid <u>homage</u> to his favorite film in his latest work.</li> <li> The artist's newest painting is a beautiful <u>homage</u> to the natural beauty of his hometown.</li></ol> 	 <ol><li> 映画監督は最新作でお気に入りの映画に<u>オマージュ</u>を捧げました。</li> <li> そのアーティストの最新の絵画は、故郷の自然美に<u>オマージュ</u>を捧げた美しい作品です。</li></ol> 
<ol><li> One of her <u>idiosyncrasies</u> is that she always wears mismatched socks.</li> <li> His <u>idiosyncrasies</u> can make him difficult to work with, but also bring a unique perspective.</li></ol> 	 <ol><li> 彼女の<u>特異性</u>の一つは、いつも合わない靴下を履くことです。</li> <li> 彼の<u>個性的な性格</u>は、彼と一緒に仕事をするのが難しいかもしれませんが、独自の視点をもたらします。</li></ol> 
<ol><li> The storm clouds in the sky indicated the <u>impending</u> thunderstorm.</li> <li> The company announced its plan for an <u>impending</u> layoff of employees.</li></ol> 	 <ol><li> 空に立ち込めた嵐雲が<u>差し迫った</u>雷雨を示していた。</li> <li> その企業は従業員の<u>迫り来る</u>レイオフ計画を発表しました。</li></ol> 
<ol><li> The author's <u>implicit</u> message in the book is that justice is not always easily achieved.</li> <li> The company's <u>implicit</u> policy is to prioritize customer satisfaction over profits.</li></ol> 	 <ol><li> その著者が書いた本の<u>暗黙の</u>メッセージは、正義を得ることが常に簡単ではないということです。</li> <li> その会社の<u>暗黙の</u>方針は、利益よりも顧客満足度を優先することです。</li></ol> 
<ol><li> The band didn't have any sheet music, so they had to <u>improvise</u> and play by ear.</li> <li> During the power outage, we had to <u>improvise</u> and use candles for light.</li></ol> 	 <ol><li> バンドは楽譜を持っていなかったので、耳で聞きながら<u>即興で演奏</u>しなければならなかった。</li> <li> 停電の間、キャンドルを使って<u>即興で対応</u>しなければなりませんでした。</li></ol> 
<ol><li> It would be <u>imprudent</u> to invest all your savings in one risky business venture.</li> <li> The politician's <u>imprudent</u> actions caused a lot of controversy and backlash.</li></ol> 	 <ol><li> リスクの高いビジネスに全ての貯蓄を投資するのは<u>軽率</u>です。</li> <li> 政治家の<u>軽率</u>な行動が多くの論争や反発を引き起こした。</li></ol> 
<ol><li> He made an <u>impulsive</u> decision to quit his job without having another one lined up.</li> <li> She's known for her <u>impulsive</u> shopping sprees, often buying things she doesn't need.</li></ol> 	 <ol><li> 彼は次の仕事が見つかってないのに、職を辞めるという<u>思いつき</u>の決断をしました。</li> <li> 彼女は<u>衝動買い</u>が多く、必要のないものを買うことで有名です。</li></ol> 
<ol><li> The injury to his leg would <u>incapacitate</u> him from playing in the game.</li> <li> A power outage could <u>incapacitate</u> the entire city's infrastructure.</li></ol> 	 <ol><li> 彼の足の怪我は彼が試合に出場できなくすることになった。</li> <li> 停電は街のインフラを<u>麻痺</u>させる可能性がある。</li></ol> 
<ol><li> The <u>incessant</u> rainfall made it difficult to drive on the slippery roads.</li> <li> His <u>incessant</u> talking during the movie annoyed the other moviegoers.</li></ol> 	 <ol><li> 滑りやすい道路を運転することが難しくなった<u>絶え間ない</u>雨。</li> <li> 映画中の彼の<u>絶え間ない</u>話し声が他の映画ファンをイライラさせた。</li></ol> 
<ol><li> The outdoor concert was cancelled due to <u>inclement</u> weather.</li> <li> The hikers took shelter in a cave during the <u>inclement</u> storm.</li></ol> 	 <ol><li> 屋外コンサートは<u>荒天</u>のため中止になりました。</li> <li> ハイカーたちは<u>荒天</u>の嵐で洞窟に避難しました。</li></ol> 
<ol><li> The evidence presented in court did not <u>incriminate</u> the defendant.</li> <li> I am not going to say anything that could <u>incriminate</u> me.</li></ol> 	 <ol><li> 法廷で提示された証拠は被告人を<u>有罪にする</u>わけではなかった。</li> <li> 私は自分を<u>自白</u>させる可能性のある発言はしないつもりだ。</li></ol> 
<ol><li> His <u>indolence</u> prevented him from completing his work on time.</li> <li> She spent the day in <u>indolence</u>, lounging on the couch and watching TV.</li></ol> 	 <ol><li> 彼の<u>怠惰</u>が彼を仕事を期限までに終わらせることを妨げた。</li> <li> 彼女は1日中<u>怠惰</u>を過ごし、ソファーに寝そべってテレビを見ていた。</li></ol> 
<ol><li> The spy managed to <u>infiltrate</u> the enemy's headquarters undetected.</li> <li> The hacker was able to <u>infiltrate</u> the company's database and steal sensitive information.</li></ol> 	 <ol><li> スパイは注意されることなく敵の本部に<u>潜入</u>することができました。</li> <li> ハッカーは企業のデータベースに<u>浸透</u>して、機密情報を盗み出すことができました。</li></ol> 
<ol><li> The old woman couldn't lift the box due to her <u>infirmity</u>.</li> <li> The company offers special accommodations for employees with <u>infirmities</u>.</li></ol> 	 <ol><li> 老女性は彼女の<u>病弱</u>により箱を持ち上げることができなかった。</li> <li> その会社は<u>疾患</u>を持つ従業員に特別な配慮を提供しています。</li></ol> 
<ol><li> The scientist came up with an <u>ingenious</u> solution to the problem.</li> <li> The artist used an <u>ingenious</u> technique to create the painting.</li></ol> 	 <ol><li> その科学者は問題に対する<u>巧妙な</u>解決策を考え出しました。</li> <li> 画家は<u>独創的な</u>技法を使って、絵を作りました。</li></ol> 
<ol><li> Her <u>ingenuity</u> in finding creative solutions to problems helped her earn the promotion.</li> <li> The company's success is due in large part to the <u>ingenuity</u> of its engineers.</li></ol> 	 <ol><li> 問題に対して創造的な解決策を見つける彼女の<u>独創性</u>が昇進に役立ちました。</li> <li> この会社の成功は、大きくはエンジニアの<u>独創性</u>によるものです。</li></ol> 
<ol><li> The comedian's jokes were full of <u>innuendo</u> that flew over the heads of children in the audience.</li> <li> The politician's speech contained a lot of <u>innuendo</u> about his opponent's personal life.</li></ol> 	 <ol><li> コメディアンのジョークは子供たちの頭上を飛び越えた<u>暗示</u>でいっぱいだった。</li> <li> 政治家のスピーチは、対戦相手のプライベートな生活について<u>ほのめかし</u>が多かった。</li></ol> 
<ol><li> Superman is often seen as an <u>invincible</u> hero who can overcome any obstacle.</li> <li> The undefeated champion boxer thought he was <u>invincible</u>, until he lost his first match.</li></ol> 	 <ol><li> スーパーマンはどんな障害にも勝つことができる<u>無敵の</u>ヒーローとして知られています。</li> <li> 無敗のチャンピオンボクサーは自分が<u>無敵だ</u>と思っていましたが、初めて負けた試合があった。</li></ol> 
<ol><li> The customer became <u>irate</u> when she found out her order was wrong.</li> <li> The coach was <u>irate</u> when the team showed up late for practice.</li></ol> 	 <ol><li> 注文が間違っていたことがわかったとき、お客様は<u>激怒</u>しました。</li> <li> チームが練習に遅刻した際、コーチは<u>激怒</u>しました。</li></ol> 
<ol><li> The damage to the computer was <u>irreparably</u> done, and we need to buy a new one.</li> <li> The fire <u>irreparably</u> damaged the historical building, and it had to be torn down.</li></ol> 	 <ol><li> コンピューターの損傷は<u>修復不能</u>であり、新しいものを買わなければなりません。</li> <li> 火災は歴史的建物を<u>修復不能</u>に損傷させ、取り壊す必要がありました。</li></ol> 
<ol><li> His <u>irresolute</u> nature made it hard for him to make decisions.</li> <li> She was <u>irresolute</u> about which college to attend.</li></ol> 	 <ol><li> 彼の優柔不断な性格は意思決定をするのが難しかった。</li> <li> 彼女はどの大学に行くか<u>決断のできない</u>状態だった。</li></ol> 
<ol><li> The bullies would <u>jeer</u> at the new student in school.</li> <li> The audience began to <u>jeer</u> at the terrible performance on stage.</li></ol> 	 <ol><li> 学校で新しい生徒に向かっていじめっ子達が<b>せせら笑い </b>を浴びせた。</li> <li> 舞台上でひどいパフォーマンスを見せたため、観客は<u>あざ笑い</u>始めた。</li></ol> 
<ol><li> She <u>jests</u> with her coworkers during lunch breaks to make the atmosphere more relaxed.</li> <li> His statement was meant to be taken seriously, but his sarcastic tone made it seem like a <u>jest</u>.</li></ol> 	 <ol><li> 彼女は昼休み中に同僚たちと<u>冗談を言って</u>、雰囲気をリラックスさせます。</li> <li> 彼の発言は真剣に受け取るべきだったが、皮肉な口調で言ったせいで、冗談に聞こえた。</li></ol> 
<ol><li> I don't want to <u>jinx</u> it, but I think we have a good chance of winning the game.</li> <li> She always wears her lucky socks for important meetings to avoid <u>jinxing</u> the outcome.</li></ol> 	 <ol><li> 勝つ可能性が高いと思いますが、<u>呪わない</u>ようにしたいです。</li> <li> 彼女は重要な会議の時にはいつも幸運を呼び込むために幸運の靴下を着用して、結果を<u>悪くする</u>のを避けます。</li></ol> 
<ol><li> The team was <u>jubilant</u> after winning the championship game.</li> <li> The parents were <u>jubilant</u> when their daughter graduated from college.</li></ol> 	 <ol><li> チームは優勝試合に勝った後、<u>歓喜の</u>気持ちに包まれた。</li> <li> 娘が大学を卒業したとき、両親は<u>大喜びの</u>気持ちになった。</li></ol> 
<ol><li> She had a <u>knack</u> for getting people to open up to her and share their secrets.</li> <li> He had a <u>knack</u> for fixing things around the house without any help.</li></ol> 	 <ol><li> 彼女は人々を開放的にし、秘密を共有するように誘導する<u>才能</u>があった。</li> <li> 彼は手伝いなしで家の中で物事を修理する<u>技術</u>を持っていた。</li></ol> 
<ol><li> The movie was disappointing with its <u>lackluster</u> plot and uninteresting characters.</li> <li> The team's <u>lackluster</u> performance in the first half resulted in a big loss.</li></ol> 	 <ol><li> その映画は、無味乾燥なプロットと興味深くないキャラクターでがっかりする<u>地味な</u>作品でした。</li> <li> チームの<u>活力のない</u>前半のパフォーマンスが大敗北につながりました。</li></ol> 
<ol><li> The boss will <u>lambaste</u> employees who don't meet their sales targets.</li> <li> The movie critic <u>lambasted</u> the new blockbuster for being too predictable.</li></ol> 	 <ol><li> ボスは目標の売り上げを達成しない従業員を<u>厳しく叱責する</u>。</li> <li> 映画評論家は、新作映画が予想通りの内容であるとして<u>痛烈に批評した</u>。</li></ol> 
<ol><li> The lanky basketball player was able to easily reach the rim for the dunk.</li> <li> She towered over her classmates with her lanky frame.</li></ol> 	 <ol><li> 細長いバスケットボール選手はダンクをするために簡単にリムに届きました。</li> <li> 彼女はスリムな体型で同級生たちを超えていました。</li></ol> 
<ol><li> The company's commitment to reducing waste with sustainable practices is <u>laudable</u>.</li> <li> The researcher's dedication to finding a cure for the disease is <u>laudable</u>.</li></ol> 	 <ol><li> その会社が持続可能な実践によって廃棄物を減らすことに取り組む姿勢は<u>称賛に値する</u>。</li> <li> 研究者がその病気の治療法を見つけるための献身は<u>賞賛に値する</u>。</li></ol> 
<ol><li> The wedding reception was a <u>lavish</u> affair with a grand buffet, live music, and fireworks.</li> <li> The billionaire businessman lives in a <u>lavish</u> mansion with a private movie theater, swimming pool, and tennis court.</li></ol> 	 <ol><li> 結婚式の披露宴は、豪華なビュッフェ、ライブ音楽、花火で<u>贅沢</u>なものでした。</li> <li> 億万長者のビジネスマンは、プライベートの映画館、プール、テニスコートがある<u>豪華</u>な邸宅に住んでいます。</li></ol> 
<ol><li> He was fired for being <u>lax</u> in his job responsibilities.</li> <li> The teacher had a <u>lax</u> grading policy, which made the students happy.</li></ol> 	 <ol><li> 彼は仕事上の責任を怠ったため解雇されました。</li> <li> 先生は評価の基準が<u>緩い</u>ため、生徒たちは喜んでいました。</li></ol> 
<ol><li> The magician was able to <u>levitate</u> off the ground and float in mid-air.</li> <li> Some people claim that they can <u>levitate</u> objects with their mind.</li></ol> 	 <ol><li> そのマジシャンは地面から<u>浮かび上がり</u>、空中で浮遊することができました。</li> <li> 一部の人々は、意識力で物体を<u>浮かび上がらせ</u>ることができると主張しています。</li></ol> 
<ol><li> The two companies decided to <u>litigate</u> their contract dispute in court.</li> <li> It can be expensive to <u>litigate</u> a case, so it's important to consider alternative dispute resolution methods.</li></ol> 	 <ol><li> 2つの会社は、裁判所で契約紛争を<u>訴訟</u>することに決めました。</li> <li> ケースを<u>訴訟</u>するのは高額になることがありますので、代替紛争解決方法を考慮することが重要です。</li></ol> 
<ol><li> The museum is hosting a talk by a <u>luminary</u> in the field of art history.</li> <li> The concert featured several <u>luminaries</u> of the jazz world.</li></ol> 	 <ol><li> 美術史の<u>著名人</u>がトークを開催する美術館があります。</li> <li> コンサートには、ジャズ界のいくつかの<u>著名人</u>が出演しました。</li></ol> 
<ol><li> The news article was filled with <u>lurid</u> details about the crime scene.</li> <li> The horror movie had <u>lurid</u> scenes of violence and gore.</li></ol> 	 <ol><li> そのニュース記事には事件現場に関する<u>おぞましい</u>詳細が満載でした。</li> <li> そのホラー映画には暴力やグロテスクな<u>恐ろしい</u>シーンがありました。</li></ol> 
<ol><li> His <u>malevolent</u> behavior towards his colleagues eventually got him fired.</li> <li> The old abandoned house had a <u>malevolent</u> aura that made people feel uneasy.</li></ol> 	 <ol><li> 彼の同僚への<u>悪意のある</u>行動が、ついに彼を解雇させた。</li> <li> 古い放棄された家は、人々に不安を感じさせる<u>邪悪な</u>オーラを持っていた。</li></ol> 
<ol><li> The villagers' <u>meager</u> resources were not enough to withstand the drought.</li> <li> He survived on a <u>meager</u> diet of bread and water for weeks.</li></ol> 	 <ol><li> 村人たちの貧しい資源では干ばつに耐えられませんでした。</li> <li> 彼は数週間、パンと水という貧しい食事で生き残りました。</li></ol> 
<ol><li> The beautiful sunset over the ocean <u>mesmerized</u> everyone on the beach.</li> <li> The magician was able to <u>mesmerize</u> the audience with his amazing tricks.</li></ol> 	 <ol><li> 海の上に広がる美しい夕日に、ビーチにいた全員が<u>うっとり</u>しました。</li> <li> 魔法使いは素晴らしいトリックで観客を<u>魅了</u>することができました。</li></ol> 
<ol><li> She had a <u>misgiving</u> about accepting the job offer because of the long commute.</li> <li> He couldn't shake off the <u>misgiving</u> that something was off about the company's financial statements.</li></ol> 	 <ol><li> 長い通勤時間のせいで、彼女はその仕事のオファーを受けることに<u>不安</u>を感じていた。</li> <li> あの企業の財務諸表に何かがおかしいという<u>不安</u>を払拭できなかった。</li></ol> 
<ol><li> The embarrassing mistake at work really <u>mortified</u> him in front of his colleagues.</li> <li> I accidentally spilled food on my shirt at the dinner party and it <u>mortified</u> me.</li></ol> 	 <ol><li> 同僚の前での恥ずかしいミスは彼を本当に<u>屈辱</u>させました。</li> <li> パーティーで食べ物をシャツにこぼしてしまい、私は<u>屈辱</u>を感じました。</li></ol> 
<ol><li> The company was found to be <u>negligent</u> in their safety practices, leading to multiple workplace accidents.</li> <li> The doctor was sued for <u>negligent</u> medical treatment of their patient.</li></ol> 	 <ol><li> 会社は安全管理のいい加減さが原因で、職場での事故が多発したと判明しました。</li> <li> その医師は患者への<u>過失</u>医療の理由で訴えられました。</li></ol> 
<ol><li> The obsequious salesperson kept complimenting me and following me around the store, making me uncomfortable.</li> <li> The new employee was so obsequious to the boss that it was obvious he was trying to impress him.</li></ol> 	 <ol><li> ごますりするセールスパーソンが私にお世辞を言い続け、店内をついて回るため不快だった。</li> <li> 新入社員は上司に非常にサービス精神旺盛であったため、彼を感心させようとしているのが明らかであった。</li></ol> 
<ol><li> The cat was so <u>obstinate</u> that it refused to come down from the tree.</li> <li> Even after receiving a bad grade, the student remained <u>obstinate</u> about their study habits.</li></ol> 	 <ol><li> 猫はとても<u>強情</u>で、木から降りようとしませんでした。</li> <li> 悪い成績を受け取った後も、学生は自分の勉強習慣について<u>強情</u>でした。</li></ol> 
<ol><li> The black cat crossing your path is considered an <u>omen</u> of bad luck.</li> <li> The sudden drop in temperature in the middle of summer was an <u>omen</u> of an approaching storm.</li></ol> 	 <ol><li> 道を横切る黒猫は不吉な<u>前兆</u>とされています。</li> <li> 夏の中で急な気温の低下は、接近する嵐の<u>前触れ</u>でした。</li></ol> 
<ol><li> The athlete needs to find the <u>optimum</u> performance level to win the championship.</li> <li> The restaurant sets the temperature to the <u>optimum</u> level for cooking the perfect steak.</li></ol> 	 <ol><li> スポーツ選手は優勝するために<u>最適</u>なパフォーマンスレベルを見つける必要があります。</li> <li> レストランは完璧なステーキを調理する<u>最適</u>な温度に設定します。</li></ol> 
<ol><li> The company offered me a paltry salary for the job, so I turned it down.</li> <li> Despite working long hours every day, the farmer's earnings were paltry compared to his expenses.</li></ol> 	 <ol><li> その会社は私に仕事のためにわずかな給料を申し出たので、私は断りました。</li> <li> 毎日長時間働きながら、農家の収益は経費に比べてわずかでした。</li></ol> 
<ol><li> The <u>pandemic</u> has forced many businesses to close permanently.</li> <li> Face masks and social distancing are necessary precautions during a <u>pandemic</u>.</li></ol> 	 <ol><li> <u>パンデミック</u>の影響で多くのビジネスが永久に閉鎖を余儀なくされました。</li> <li> <u>パンデミック</u>中には、マスク着用やソーシャルディスタンスが必要な予防措置です。</li></ol> 
<ol><li> Mary is a <u>paragon</u> of beauty and grace, admired by all who know her.</li> <li> The young athlete is considered a <u>paragon</u> of dedication and hard work by his coaches.</li></ol> 	 <ol><li> メアリーは美しさと優雅さの<u>模範</u>であり、彼女を知るすべての人に賞賛されています。</li> <li> 若いアスリートは、コーチたちからの献身と努力の<u>模範</u>と考えられています。</li></ol> 
<ol><li> His <u>pedantic</u> way of speaking made it difficult for others to follow his train of thought.</li> <li> The professor's <u>pedantic</u> lectures were often seen as tedious by his students.</li></ol> 	 <ol><li> 彼の話し方は<u>学術的すぎる</u>ため、他の人達は彼の考えを理解することが難しかった。</li> <li> 教授の<u>煩わしい学問的な</u>講義は、学生たちにとって退屈だと思われていました。</li></ol> 
<ol><li> The difference in color between the two paints was <u>perceptible</u> even to untrained eyes. </li> <li> The impact of the pandemic on the economy was <u>perceptible</u> in a matter of weeks. </li></ol> 	 <ol><li> 2つのペイントの色の違いは、訓練されていない目でも<u>感知できる</u>ほどでした。</li> <li> パンデミックが経済に与えた影響は数週間で<u>感じられる</u>程度でした。</li></ol> 
<ol><li> The employee's <u>perfunctory</u> response to the customer's complaint did not satisfy them.</li> <li> The politician's speech was filled with <u>perfunctory</u> statements and lacked substance.</li></ol> 	 <ol><li> 従業員の<u>いい加減な</u>返答は、顧客の苦情に満足させませんでした。</li> <li> 政治家のスピーチは、<u>おおよその</u>陳述が多く、本質を欠いていました。</li></ol> 
<ol><li> The new employee is very <u>personable</u> and has made friends with everyone in the office.</li> <li> The customer was impressed with the <u>personable</u> service they received at the restaurant.</li></ol> 	 <ol><li> 新入社員は非常に<u>愛想がよく</u>、オフィスのみんなと親しくなりました。</li> <li> その客は、レストランで受けた<u>愛想のよい</u>サービスに感心しました。</li></ol> 
<ol><li> The student was accused of <u>plagiarism</u> for copying entire paragraphs from an online article.</li> <li> The consequences of <u>plagiarism</u> in academic writing can include a failing grade or even expulsion.</li></ol> 	 <ol><li> その生徒は、オンライン記事から段落をそのままコピーしたことで<u>盗作</u>の罪に問われた。</li> <li> 学術論文における<u>盗作</u>の結果として、不合格や退学などの処分が下されることがある。</li></ol> 
<ol><li> His speech was full of empty <u>platitudes</u> that didn't offer any real solutions.</li> <li> The politician's <u>platitude</u> about unity sounded hollow after his divisive actions.</li></ol> 	 <ol><li> 彼のスピーチは、実際の解決策を提供しない空虚な<u>決まり文句</u>でいっぱいだった。</li> <li> 政治家の統一に関する<u>大義名分</u>は、彼の分裂的な行動によって虚偽に聞こえた。</li></ol> 
<ol><li> The restaurant owner was caught trying to <u>poach</u> a chef from a rival restaurant.</li> <li> Hunting and <u>poaching</u> of endangered species is illegal.</li></ol> 	 <ol><li> レストランオーナーは、ライバル店からシェフを<u>引き抜こう</u>としたところを捕まえられました。</li> <li> 絶滅危惧種の狩猟や<u>密猟</u>は違法です。</li></ol> 
<ol><li> He felt like his job was in a <u>precarious</u> position because the company was going bankrupt.</li> <li> The hiker had to navigate through the <u>precarious</u> rocky terrain to reach the summit.</li></ol> 	 <ol><li> 会社が破産寸前であるため、彼の仕事は<u>危うい</u>状態だと感じていました。</li> <li> ハイカーは、頂上に到達するため<u>不安定な</u>岩肌を乗り越えなければなりませんでした。</li></ol> 
<ol><li> The dent in the car's bumper was a <u>protrusion</u> that couldn't be fixed.</li> <li> The rock formation had a small <u>protrusion</u> that looked like a nose.</li></ol> 	 <ol><li> 車のバンパーにあるへこみは、修復できない<u>突起物</u>でした。</li> <li> 岩の形状には、鼻のように見える小さな<u>突起</u>がありました。</li></ol> 
<ol><li> The new CEO promised to <u>purge</u> the company of any corrupt employees.</li> <li> After her breakup, she decided to <u>purge</u> her closet of all her ex's clothes.</li></ol> 	 <ol><li> 新しいCEOは、腐敗した従業員を<u>追放する</u>と約束しました。</li> <li> 彼女は別れた後、元彼の服をすべてクローゼットから<u>排除する</u>ことに決めました。</li></ol> 
<ol><li> The teacher tried to <u>quell</u> the students' excitement during the field trip.</li> <li> The new policy was implemented to <u>quell</u> the rising crime rates in the city.</li></ol> 	 <ol><li> 教師は遠足中の生徒たちの興奮を<u>抑える</u>ようにした。</li> <li> 新しい方針は都市の犯罪率の上昇を<u>抑える</u>ために実施された。</li></ol> 
<ol><li> I drank a whole bottle of water to <u>quench</u> my thirst after the long hike.</li> <li> The rain finally came to <u>quench</u> the flames of the wildfire.</li></ol> 	 <ol><li> 長いハイキングの後、喉を<u>潤す</u>ために水のボトル一本を飲みました。</li> <li> 雨が降って、ついに山火事の炎を<u>消し止めました</u>。</li></ol> 
<ol><li> The elephant went on a <u>rampage</u> through the village, destroying everything in its path.</li> <li> The protestors went on a <u>rampage</u>, breaking windows and setting fire to cars.</li></ol> 	 <ol><li> ゾウは村中に<u>暴れ始め</u>、道筋にあるもの全部を破壊していった。</li> <li> デモ隊は<u>暴れ出し</u>、窓を割って車を燃やし始めた。</li></ol> 
<ol><li> The company's <u>rationale</u> for downsizing is to reduce costs and ensure long-term profitability.</li> <li> The scientist explained the <u>rationale</u> behind their research study in a detailed report.</li></ol> 	 <ol><li> 会社が人員削減をする<u>理由</u>は、コストを削減し、長期的な利益を確保するためです。</li> <li> 科学者は、詳細なレポートで研究調査の<u>根拠</u>を説明しました。</li></ol> 
<ol><li> The lawyer was able to <u>rebut</u> the prosecution's argument with a strong alibi.</li> <li> The scientist published a study to <u>rebut</u> the claims of the anti-vaccine movement.</li></ol> 	 <ol><li> 弁護士は強力なアリバイで検察側の主張を<u>反論</u>することができました。</li> <li> 科学者は、反ワクチン運動の主張を<u>反駁</u>するために研究を発表しました。</li></ol> 
<ol><li> The author was known to be <u>reclusive</u>, rarely making public appearances or giving interviews. </li> <li> After retiring from the music industry, the singer became increasingly <u>reclusive</u>, rarely leaving their house. </li></ol> 	 <ol><li> その著者は、めったに公の場に姿を現さず、インタビューも受けないという<u>隠遁的な</u>人だった。</li> <li> 音楽業界から引退した後、その歌手はますます<u>隠遁的</u>になり、自宅からあまり出ることがなくなった。</li></ol> 
<ol><li> You can <u>redeem</u> your points for gift cards or merchandise.</li> <li> She hoped that good deeds in her life would <u>redeem</u> her soul in the afterlife.</li></ol> 	 <ol><li> ポイントを利用して、ギフトカードや商品を<u>交換</u>できます。</li> <li> 彼女は、人生での善行が来世で彼女の魂を<u>救う</u>ことを望んでいた。</li></ol> 
<ol><li> It's only fair that the victim receives <u>redress</u> for the damages caused by the company's negligence.</li> <li> The union is demanding <u>redress</u> for the workers who were unfairly laid off.</li></ol> 	 <ol><li> 会社の過失によって被害者が被った損害の<u>償い</u>を受けるのは当然です。</li> <li> 労働組合は不当に解雇された労働者の<u>補償</u>を要求しています。</li></ol> 
<ol><li> The scientist tried to <u>refute</u> the theory that the Earth is flat.</li> <li> She provided evidence to <u>refute</u> the argument made by her opponent.</li></ol> 	 <ol><li> 科学者は地球が平面であるという理論を<u>反論しようとしました</u>。</li> <li> 彼女は証拠を提供して、相手の主張を<u>反駁しました</u>。</li></ol> 
<ol><li> Taking a long vacation can help you <u>rejuvenate</u> and feel refreshed.</li> <li> Using a face mask regularly can <u>rejuvenate</u> your skin and improve its texture.</li></ol> 	 <ol><li> 長期のバケーションを取ることは、<u>活気を取り戻し</u>、リフレッシュするのに役立ちます。</li> <li> 定期的にフェイスマスクを使用することで、肌を<u>若返らせ</u>、質を向上させることができます。</li></ol> 
<ol><li> The company will <u>remit</u> your paycheck every two weeks.</li> <li> The charity organization will <u>remit</u> the donations to the designated beneficiaries.</li></ol> 	 <ol><li> 会社は2週間ごとにあなたの給料を<u>振り込む</u>でしょう。</li> <li> チャリティ団体は寄付金を指定された受益者に<u>送金する</u>でしょう。</li></ol> 
<ol><li> The company offers a competitive <u>remuneration</u> package to attract top talent.</li> <li> The freelance writer negotiated a higher <u>remuneration</u> for her latest article.</li></ol> 	 <ol><li> 会社は優秀な人材を引き付けるために競争力のある<u>報酬</u>パッケージを提供しています。</li> <li> フリーランスライターは、最新の記事の<u>報酬</u>を交渉しました。</li></ol> 
<ol><li> He promised to pay me back, but then he <u>renege</u>d on his word.</li> <li> The company <u>renege</u>d on their offer to give employees a bonus.</li></ol> 	 <ol><li> 彼は私に返済する約束をしたが、その後言葉を<u>破った</u>。</li> <li> その企業は従業員にボーナスを与えるというオファーを<u>取り消した</u>。</li></ol> 
<ol><li> The strong smell of the chemical spray can <u>repel</u> insects.</li> <li> His rude behavior was enough to <u>repel</u> anyone who tried to befriend him.</li></ol> 	 <ol><li> 化学スプレーの強い匂いは昆虫を<u>撃退</u>することができます。</li> <li> 彼の失礼な態度は、彼と友達になろうとする人々を<u>排除</u>するのに十分でした。</li></ol> 
<ol><li> He was <u>reticent</u> about his past and didn't like to talk about it.</li> <li> The new employee remained <u>reticent</u> in meetings and didn't contribute much.</li></ol> 	 <ol><li> 彼は過去について<u>口を閉ざす</u>ことが多く、話したがりませんでした。</li> <li> 新入社員は会議で<u>寡黙</u>で、あまり貢献しなかった。</li></ol> 
<ol><li> The child only has a <u>rudimentary</u> understanding of math concepts.</li> <li> This company's first product was a <u>rudimentary</u> version of what they produce now.</li></ol> 	 <ol><li> その子供は数学の概念に<u>初歩的な</u>理解しか持っていません。</li> <li> この会社の最初の製品は今作っているものの<u>初歩的な</u>バージョンでした。</li></ol> 
<ol><li> The politician hesitated to accept the bribe because it went against his <u>scruples</u>.</li> <li> She had no <u>scruples</u> about lying to get what she wanted.</li></ol> 	 <ol><li> 政治家は、賄賂を受け取ることが自分の<u>良心</u>に反するため、ためらいました。</li> <li> 彼女は、得たいものを手に入れるために嘘をつくことに何の<u>ためらい</u>もありませんでした。</li></ol> 
<ol><li> The accountant was known for being <u>scrupulous</u> in his financial dealings.</li> <li> The professor was very <u>scrupulous</u> in grading his students' papers.</li></ol> 	 <ol><li> 会計士は財務取引において<u>誠実な</u>ことで知られていました。</li> <li> 教授は学生の論文を評価する際、非常に<u>良心的な</u>だった。</li></ol> 
<ol><li> The old bookstore gave the <u>semblance</u> of being abandoned, but was actually filled with hidden treasures.</li> <li> The actor put on a fake smile and maintained a <u>semblance</u> of composure during the interview.</li></ol> 	 <ol><li> 古い本屋は放棄されているように見えましたが、実際には隠れた宝物でいっぱいでした。</li> <li> 俳優は偽の笑顔を浮かべ、インタビュー中に落ち着きを<u>装った</u>。</li></ol> 
<ol><li> The <u>shrewd</u> businessman made a clever investment and earned a big profit.</li> <li> She is known for her <u>shrewd</u> negotiating skills and always gets the best deal.</li></ol> 	 <ol><li> <u>機敏な</u>ビジネスマンは賢い投資をして大きな利益を得ました。</li> <li> 彼女は彼女の<u>巧妙な</u>交渉術で知られており、常に最高の取引を得ます。</li></ol> 
<ol><li> He gave a <u>sneer</u> when the teacher announced the pop quiz.</li> <li> The politician's opponent responded with a <u>sneer</u> to his proposal.</li></ol> 	 <ol><li> 先生がサプライズクイズを発表したとき、彼は<u>嗤った</u>。</li> <li> 政治家の対立候補は提案に<u>冷笑した</u>。</li></ol> 
<ol><li> Please clean up the <u>spillage</u> on the kitchen floor.</li> <li> The waiter apologized for the <u>spillage</u> of wine on the tablecloth.</li></ol> 	 <ol><li> 台所の床にある<u>こぼれたもの</u>を片付けてください。</li> <li> ウェイターは、テーブルクロスに<u>こぼれたもの</u>のことを謝罪しました。</li></ol> 
<ol><li> The superstar athlete's agent decided to <u>spurn</u> the lower offer from the team.</li> <li> After being rejected by the company, he felt a sense of <u>spurn</u> and began looking for other job opportunities.</li></ol> 	 <ol><li> スーパースターアスリートのエージェントは、チームからの低いオファーを<u>拒否する</u>ことに決めました。</li> <li> 会社に断られた後、彼は<u>拒否された</u>と感じ、他の求職機会を探し始めました。</li></ol> 
<ol><li> The university has <u>stringent</u> admission requirements for their graduate programs.</li> <li> The company has <u>stringent</u> safety regulations to ensure the well-being of their employees.</li></ol> 	 <ol><li> 大学は大学院プログラムの入学要件が<u>厳格</u>です。</li> <li> 会社は従業員の福利を確保するために<u>厳格</u>な安全規則を持っています。</li></ol> 
<ol><li> She is very <u>submissive</u> in her marriage and always defers to her husband's wishes.</li> <li> The CEO expects <u>submissive</u> behavior from his employees and does not tolerate any pushback.</li></ol> 	 <ol><li> 彼女は結婚生活で非常に<u>従順</u>であり、常に夫の希望に従っています。</li> <li> CEOは従業員に<u>従順</u>な行動を期待し、反発を許しません。</li></ol> 
<ol><li> His speech was <u>succinct</u> and to the point, lasting only five minutes.</li> <li> The instructions on the manual are <u>succinct</u> and easy to understand.</li></ol> 	 <ol><li> 彼のスピーチは<u>簡潔</u>で論点を明確にしたもので、5分しか続きませんでした。</li> <li> 取扱説明書の説明は<u>簡明</u>で分かりやすいです。</li></ol> 
<ol><li> The steak was so <u>succulent</u> that it practically melted in my mouth.</li> <li> I bought a bunch of <u>succulent</u> plants to decorate my apartment.</li></ol> 	 <ol><li> そのステーキはとても<u>ジューシーな</u>ので、口の中で溶けそうでした。</li> <li> アパートを飾るために、<u>多肉植物</u>の束を買いました。</li></ol> 
<ol><li> With hard work and determination, you can <u>surmount</u> any obstacle in your way.</li> <li> The team was able to <u>surmount</u> their previous losses and win the championship game.</li></ol> 	 <ol><li> 努力と決意を持ってすれば、道に立ちはだかる障害を<u>克服</u>できます。</li> <li> チームは前の敗北を<u>克服</u>し、優勝試合に勝つことができました。</li></ol> 
<ol><li> Leaving the silverware out in the open will quickly <u>tarnish</u>.</li> <li> The scandal has begun to <u>tarnish</u> the reputation of the company.</li></ol> 	 <ol><li> 銀器を放置するとすぐに<u>汚れ</u>がつきます。</li> <li> そのスキャンダルによって、その会社の評判が<u>損なわ</u>れ始めています。</li></ol> 
<ol><li> The toddler managed to <u>teeter</u> across the room before falling.</li> <li> The old bridge began to <u>teeter</u> dangerously as the heavy truck passed over it.</li></ol> 	 <ol><li> 赤ちゃんは転びながら、部屋を<u>よちよち歩き</u>ました。</li> <li> 重いトラックが通過すると、古い橋は危険に<u>ゆらゆらと</u>揺れ始めました。</li></ol> 
<ol><li> The plans for the project are still <u>tentative</u> and subject to change.</li> <li> The couple made a <u>tentative</u> agreement to meet for dinner on Friday.</li></ol> 	 <ol><li> プロジェクトの計画はまだ<u>暫定的</u>で、変更の可能性があります。</li> <li> カップルは金曜日にディナーをする<u>暫定的な</u>合意をしました。</li></ol> 
<ol><li> The thunderstorm <u>thwarted</u> our plans for a picnic in the park.</li> <li> The goalkeeper's quick reflexes <u>thwarted</u> the opponent's attempt at scoring a goal.</li></ol> 	 <ol><li> 雷雨が起こったため、公園でのピクニック計画は<u>水泡</u>に帰した。</li> <li> ゴールキーパーの素早い反射は、相手のゴール狙いを<u>阻止</u>した。</li></ol> 
<ol><li> The painting had a <u>tinge</u> of blue in the background.</li> <li> Her voice had a <u>tinge</u> of sadness when she spoke about her childhood.</li></ol> 	 <ol><li> 絵には背景に青い<u>色合い</u>があった。</li> <li> 彼女が子供時代に話をするとき、声には少し<u>悲しみの色合い</u>があった。</li></ol> 
<ol><li> The music teacher asked the student to <u>transpose</u> the song into a lower key.</li> <li> When converting a major chord into a minor chord, you need to <u>transpose</u> the third note down a half-step.</li></ol> 	 <ol><li> 音楽の先生は生徒に曲を下のキーに<u>移調</u>するように頼みました。</li> <li> メジャーコードをマイナーコードに変換する場合、第三の音符をハーフステップ下に<u>移調</u>する必要があります。</li></ol> 
<ol><li> The decision to cut funding to the after-school program was a <u>travesty</u>.</li> <li> The company's treatment of its employees during the pandemic was a <u>travesty</u> of justice.</li></ol> 	 <ol><li> 放課後プログラムへの資金削減の決定は<u>悲劇的な出来事</u>でした。</li> <li> パンデミック中の従業員への会社の扱いは正義の<u>冒涜</u>でした。</li></ol> 
<ol><li> The writer used a <u>trite</u> plot that was predictable from the beginning.</li> <li> The comedian's jokes were <u>trite</u> and lacked originality.</li></ol> 	 <ol><li> その作家は、最初から予測できる<u>決まり文句</u>プロットを使用しました。</li> <li> そのコメディアンのジョークは<u>陳腐</u>で、オリジナリティに欠けていました。</li></ol> 
<ol><li> The unruly crowd refused to disperse even after the police arrived.</li> <li> The teacher had a lot of trouble with the unruly students in her class.</li></ol> 	 <ol><li> 警察が到着しても、暴徒化した群衆は解散しなかった。</li> <li> 先生はクラスの手に負えない生徒たちに苦労した。</li></ol> 
<ol><li> The car crashed into the tree, but miraculously the driver walked away <u>unscathed</u>.</li> <li> Despite the explosion, all of the precious artifacts were found <u>unscathed</u>.</li></ol> 	 <ol><li> 車が木に衝突したが、驚くべきことに運転手は無傷で歩いていった。</li> <li> 爆発にもかかわらず、貴重な文化財はすべて<u>無傷</u>で見つけられました。</li></ol> 
<ol><li> His <u>urbane</u> manners made him popular among the upper class.</li> <li> The ambassador's <u>urbane</u> speech impressed the foreign guests.</li></ol> 	 <ol><li> 彼の上品なマナーは上流階級の間で人気を博した。</li> <li> 大使の上品な演説は外国の客を感心させた。</li></ol> 
<ol><li> The knight was <u>valiant</u> in his fight against the dragon.</li> <li> The firefighters were <u>valiant</u> in their efforts to save the burning building.</li></ol> 	 <ol><li> 騎士はドラゴンと戦う中で<u>勇敢</u>でした。</li> <li> 消防士たちは燃える建物を救うために<u>勇敢</u>に働きました。</li></ol> 
<ol><li> The <u>veracity</u> of her testimony was called into question during the trial.</li> <li> The article's <u>veracity</u> was confirmed by multiple sources before it was published.</li></ol> 	 <ol><li> 彼女の証言の<u>真実性</u>が裁判中に疑問視されました。</li> <li> 記事の<u>真実性</u>は公表される前に複数の情報源から確認されました。</li></ol> 
<ol><li> Since she couldn't travel herself, she lived <u>vicariously</u> through her daughter's travel stories.</li> <li> I got to experience the thrill of skydiving through a <u>vicarious</u> virtual reality experience.</li></ol> 	 <ol><li> 彼女自身が旅行できなかったため、娘の旅行の話を聞きながら<u>代理体験</u>しました。</li> <li> 私はバーチャルリアリティを通じての<u>代理体験</u>でスカイダイビングのスリルを体験しました。</li></ol> 
<ol><li> His confidence in his decision began to <u>waver</u> when he heard opposing arguments.</li> <li> The company's profits have started to <u>waver</u> due to increased competition.</li></ol> 	 <ol><li> 反対意見を聞いた時、彼の決断に対する自信が揺らぎ始めた。</li> <li> 競合の増加により、その会社の利益が揺らぎ始めた。</li></ol> 
