as it stands	現状では	
crash down	崩れる，台無しになる	
replace A by B	AをBで置き換える	
categorize A as B	AをBの範疇に分ける	
be critical of	に批判的である	
town twinning	姉妹都市提携	
public official	公務員	
natural disaster	自然災害	
in particular	特に	
file a suit	提訴する，訴訟を提出する	
in excess	過度に，余分に	
let out	外に出す，解放する	
buckle down	精を出す，全力を尽くす	
come through	を通り抜ける，やり通す	
chip in	寄付する，金を出す	
slip up	やり損なう，うっかり誤る	
nod off	眠り込む，眠る	
cross over	越えて渡る	
gear up	準備を整える，ギアを高速に入れる	
leave off	脱いだままでいる，着ずにいる	
lock up	刑務所，留置所	
kick around	粗末に扱う，酷使する	
walk off with	から歩いて出る，立ち去る	
best for	～にとって最良の	
pull together	力を結集する，協力する	
burst into	乱入する、急にし始める	
go about	歩き回る、広まる	
pass up	逃す，断る	
mess up	台無しにする	
talk over	相談する、議論する	
up front	前もって，率直に	
at hand	手元に，近い将来	
back out	取り消す，約束を破る	
on hand	近くに，手元に	
step in	介入する，立ち入る	
put down	下へ降ろす	
tear up	引き裂く	
around the clock	一日中	
come to a halt	一旦停止する	
take A for granted	を当然と思う	
hand down	を伝える，を降ろす	
leave out	を省略する，を除外する	
refrain from	を控える、を慎む	
gaze at	を見つめている，をじっと見ている	
stare at	をじっと見つめる	
put through	やり遂げる，に電話を繋ぐ	
by any chance	もしかして，万が一	
pull off	もぎ取る，成功を掴む	
first and foremost	まず第一に，真っ先に	
make for	へ向かう，に役立つ	
for the purpose of	の目的で，を目的に	
in the midst of	の真っただ中	
owing to	のために，のおかげで	
look through	に目を通す，一通り調べる	
be suitable for	に適している，に適した	
vote for	に賛成する，に投票する	
cut out for	に向いている、向き	
lean on	に寄りかかる，にもたれる	
in addition to	に加えて	
come in contact with	と接触する，連絡する	
die of	で死ぬ，亡くなる	
make do with	で間に合わせる，でやりくりする	
so as to	するように，なるように	
submit A to B	AをBに提出する	
as far as A is concerned	Aに関すると，Aに関する限りでは	
adjust A to B	AとBを調整する	
congratulate on	祝う，祝いの言葉を述べる	
be into	に夢中になる，に嵌っている	
take steps	順序を踏む，対策を打つ	
be identical to	と同一である，と同じである	
to some degree	ある程度，一定程度	
be qualified to	の資格がある	
without reserve	遠慮せず，遠慮なく	
in all probability	十中八九	
be worthy to	に値する，価値がある	
as A as any	Aで誰にも劣らず	
free of charge	無料で，タダで	
improve on	を改善する，改良する	
be addicted to	の中毒になる，癖になる	
derive from	から派生する	
get hold of	を手に入れる，に連絡を取る	
scold A for B	BのことでAを叱る	
a bunch of	たくさんの，多量の	
as A as ever	いつものように，相変わらず	
as is	そのまま，現状のままで	
fix on	を固定する，取り付ける	
think much of	を尊重する，評価する	
in parallel	並行して，並んで	
be apt to	しがちである，する癖がある	
take A into consideration	Aを考慮に入れる	
up to now	今まで，現在まで	
attend on	に参加する，付き添う	
be faithful to	に忠義を尽くす，付いていく	
provided that	である限り，という条件で	
come out with	を見せる，口に出す	
interfere with	に干渉する	
hold still	止まる，座る	
commit suicide	自殺する	
at the end of the day	一日の終わりに	
way to go	良い調子	
forget oneself	我を忘れる，夢中になる	
for real	本物の，本気で	
buy out	買い取る，株を買い取る	
pretend to do	するふりをする	
quite a bit	たくさんの，かなりの	
now and again	時々	
in succession	連続して，引き続き	
either way	どちらにしても，どのみち	
convict of	で有罪判決とする	
"catch A&#x27;s eye"	Aの目を引く	
at large	自由で，捕らわれないで	
surrender to	に降伏する	
split the bill	割り勘をする，割り勘	
elaborate on	を詳しく述べる，詳しく話す	
bear fruit	実を結ぶ，効果を生み出す	
by force	力ずくで，無理やり	
draw into	引き込む，引き入れる	
hardly， before	ほとんど、前にしたことがない	
in a passion	情熱を持って	
take heart	勢い付く，元気になる	
fall behind	遅れる，追い越される	
spell out	綴りを書く，綴りを言う	
in doubt	疑って，迷って	
be impatient with	イライラして，もどかしくて	
confide in	信じる，許す	
be distinct from	とは区別する，とは異なって	
ever since	それ以来，それ以降	
none the less	それでもなお	
in years	年間で	
mother tongue	母国語	
to the full	いっぱいに，心ゆくまで	
top off	仕上げをする，終える	
sleep on	を一晩寝て考える，決定を一日延ばす	
check up on	調べる，照合する	
crop up	突然現れる，生じる	
entrust A to B	AからBに委託する	
build A into B	AをBに組み入れる	
touch down	着陸する，降り立つ	
close call	間一髪，際どいところ	
tens of thousands	何万もの，数万の	
cash in	現金に変える，現金を投入する	
good for nothing	何の役にも立たない	
be devoted to	に専念した，に夢中な	
black out	消灯する，黒く塗りつぶす	
convince A of B	BについてAを納得させる	
bear out	裏付ける，支持する	
at home with	慣れて，精通して	
as much as to say	と言わんばかりに	
oddly enough	奇妙なことに，おかしなことに	
be bent on	熱心で，決意を持って	
crank up	刺激する，始動する	
be consistent with	に首尾一貫している	
loosen up	緩める，ほぐす	
beware of	注意する，気を付ける	
take delight in	喜びを得る，面白がる	
as it happens	それが起こるとき	
in prospect	予期されて，見込みがあって	
illustrate A with B	BでAを描く，表現する	
starve to death	飢え死にする，餓死する	
interfere in	に干渉する	
on the decline	衰退中の，下降中の	
bet on	に賭ける，賭けをする	
concentrate A on B	AをBに集中させる	
at intervals	飛び飛びに，時々	
free up	解放する，自由にする	
by coincidence	偶然に，たまたま	
hang over	～の上に張り出す、～の上に突き出る	
operate on	を運営する，操作する	
be crowded with	で混んでいる	
ask A out	Aを誘い出す	
be applicable to	に当てはまる，に適している	
on principle	原則として	
originate in	に端を発する，起因する	
catch up on	に追い付く	
classify A into B	AをBに分類する	
inquire into	に尋ねる	
irrespective of	に関わりなく	
can afford to do	する余裕がある	
at the sacrifice of	の犠牲によって	
live off	によって生きる，で生計を立てる	
watch over	見守る，見張る	
one and only	たった一つだけ，一つ限りの	
from top to bottom	上から下まで	
take up with	と仲良くなる	
for life	一生の，生きるために	
close out	締め切る，売り払う	
break the ice	話の口火を切る	
be in for	に直面しそうな，に参加する	
kick back	逆襲する，見返り	
cough up	咳払いする	
abstain from	を控える，慎む	
at a premium	特別に、割増の	
wash up	顔や手を洗う，皿洗いをする	
get over with	を乗り越える，克服する	
catch on with	に追いつく	
none the more	それでもなお	
nothing much	大したことはない，特に何もない	
tie into	結び付ける，調和させる	
ring a bell	思い出させる，聞いたことのある	
out of the picture	目立たない，重要でない	
go places	遊びまわる，出世する	
carry over	持ち越す	
lay in	蓄える，仕入れる	
draw out	引き抜く，引き伸ばす	
take pity on	に同情する，哀れむ	
fence in	を囲い込む	
touch off	発射させる	
write off	すぐに書く	
buy off	お金で解決する	
"at one&#x27;s disposal"	自由に，好きなように	
fall victim to	の犠牲になる	
give of	分け与える	
make an end of	で済ませる，終わらせる	
stand to reason	筋が通る，道理にかなう	
bail out	脱出する，救済する	
tell A apart	Aを区別する	
at a standstill	停止中の，行き詰って	
go in for	に参加する，携わる	
in recognition of	の認識で	
in a breath	一息で	
set at	評価する，設置する	
glare at	睨みつける	
kill oneself	自殺する，自害する	
rub off	こすり落とす	
lean over	寄りかかる，屈む	
stay put	入れたまま，元のままで	
on edge	イライラして	
be proficient in	に精通している	
take cover	隠れる，避難する	
up in the air	漠然とした，未決定の	
ease up	緩む，和らぐ	
lie with	の役目である，次第である，	
make matters worse	問題を悪化させる	
take A by surprise	Aを驚かせる	
off duty	非番の，勤務時間外の	
be appropriate to	にふさわしい，適している	
out and about	出歩いて，外に出られる	
hook up	つなぐ，引っかける	
notify A of B	AにBを通知する	
in a vacuum	真空で，真空中で	
speak well of	の事を良く言う，ほめる	
come in handy	助けになる，便利な	
be oblivious of	忘れがちな，気づかないで	
hide out	隠れる，潜伏する	
in a second	すぐに，一瞬で	
clear away	取り除く，片づける	
no offense	悪気はなく，悪気なく	
high and low	高きも低きも，あらゆる人達	
stamp out	踏み消す，鎮圧する	
be versed in	に精通している，に詳しい	
drink in	吸収する，見とれる	
under the table	こっそりと，そでの下で	
in focus	焦点があっている	
in a million	最高の	
to all appearances	どうみても，明らかに	
crash into	衝突する，ぶち当たる	
set A apart	Aを離す	
run off	流出する，逃げる	
look beyond	視野を広げる，先を見据える	
chew on	かじりつく，しゃぶり付く	
with a start	はっとして，ビクッとして	
pop in	飛び込む，飛び入る	
be incapable of	出来ない，不可能な	
dream on	夢を見続ける	
down to earth	分別のある，現実的な	
go to extremes	極端に行く，行き過ぎる	
to be frank	率直に言って，正直なところ	
in diameter	直径で	
be innocent of	無罪の，罪のない	
keep in	抑える，閉じ込める	
entrust A with B	AにBを委託する，任せる	
on the subject of	に関して，について	
break the news	悲報を伝える	
be inferior to	より劣って	
be badly off	貧乏している，お金のない	
spit it out	白状する，吐き出すように言う	
hole up	冬眠する，隠れる	
hand in hand with	手を取り合って，手を取って	
out of the ordinary	並外れた，普通でない	
think better of	よく考える，見直す	
level out	平らげる，平らにする	
in so far as	する限りにおいて	
become of	となる，になる	
pull into	引き入れる，引き込む	
point up	強調する，際立たせる	
true to life	写実的，そっくりの	
in haste	急いで，慌てて	
in obedience to	従順で，応じて	
be disappointed at	にがっかりして	
head on	正面から，真向かいに	
expand on	について詳しく話す	
pull up to	追いつく，並ぶ	
take pains	苦労する，骨を折る	
pull the plug	停止させる	
have a clue	手がかりがある	
write out	書きつくす，書くことがなくなる	
ship out	出荷する，積み出しする	
at the cost of	の代償を払って，を犠牲にして	
consent to	に納得する、を許す	
hinge on	決定する，定まる	
hit it off	仲良くやる，ウマが合う	
turn out for	に向かう，の方向に進む	
hear out	最後まで聞く	
worlds apart	別世界の，非常に異なって	
let off	降ろす，放つ	
for the benefit of	のために	
be alien to	と調和せずに，相容れなくて	
pull away from	から引き離す	
up to speed	事情を理解している	
on the occasion of	に際して，にあたって	
beyond number	数えきれないほど，無数の	
on bail	保釈中の，出所中の	
first and last	総じて，概して	
"slip A&#x27;s mind"	Aから忘れられる	
all in one	全て含んで，一致して	
inquire of	を問い合わせる	
stop off	途中下車する	
back down on	撤回する，取り消す	
for the rest	残りについては，後は	
in due time	やがて，いつかは	
roll in	たくさん入る，転がり入る	
in the middle of nowhere	辺ぴな所に，何もない所に	
burst into laughter	吹き出す，どっと笑い出す	
do an injustice to	誤解する，価値を見誤る	
loud and clear	はっきりと，明確に	
praise A for B	AをBについて賞賛する，ほめる	
at the outset	outset: 最初に，初めは、着手、手始め、発端、発生<br>onset: 開始、始まり、着手	
pick up the tab	勘定を払う，支払いをする	
sneak up on	忍び寄る，こっそり近づく	
bite on	に真剣に取り組む，に噛みつく	
drink up	飲み干す	
"in one&#x27;s absence"	不在中に，留守中に	
in excess of	より過度に，を上回って	
the bottom line	最低限，最低ライン	
draw back	引き戻す	
serve up	仕える，食卓に出す	
under cover	内密に，隠れて	
take leave of	と告別する，別れる	
be distinguished for	と区別される	
walk away with	と一緒に歩いて出る	
in dispute	論争中の	
at no time	at no time: 決してしない<br>in no time: すぐに、すぐさま	
struggle with	と闘う，争う	
live through	生き延びる	
quarrel with	とけんかする，口論する	
under consideration	検討中の	
go overboard	極端に走る，夢中になる	
gain on	追い上げる，侵食する	
alive and well	健在で，元気で	
give A credit for B	BについてAを信用する	
just as well	差支えない，ちょうど良い	
wash out	洗い流す	
build out	構築する	
draw a line	線を引く，一線を引く	
on trial	試用中で，審理中で	
in an instant	瞬時に，一瞬で	
hard of hearing	難聴の，耳の遠い	
eat away	食い荒らす，侵食する	
yet again	再び，またまた	
rule of thumb	親指で計測すること，大雑把な方法	
make haste	急ぐ，手早くする	
want for	に欠ける，必要とする	
edge out	徐々に押しのける，辛勝する	
rise and shine	起き上がる	
jack up	吊り上げる，ジャッキで上げる	
to no avail	無駄に，役に立たずに	
beyond question	疑いもなく，確かに	
be doomed to	運命づけられる，の運命にある	
talk back to	に口答えする，言い返す	
in the abstract	理論上は，理論的には	
right off	すぐに，直ちに	
root out	根絶する，一掃する	
in the red	赤字で	
trifle with	ぞんざいに扱う，いい加減にあしらう	
be akin to	に似ている，と同種である	
admire A for B	BについてAを賞賛する	
cheat on	でずるをする，裏切る	
pay regard to	を尊重する	
get past	のそばを通る，通り抜ける	
conjure up	素早く出す，呪文で呼び出す	
out of bounds	立入禁止で，境界線を越えて	
least of all	とりわけ，最も～ない	
iron out	解決する，しわを伸ばす	
bow out	お辞儀して退出する，身を引く	
bear down	圧迫する，制圧する	
issue A to B	AをBに支給する，発行する	
be incongruous with	と矛盾する，と不一致である	
from hand to mouth	その日暮らしで	
in substance	実質上	
bear the brunt of	の矢面に立つ，まともに受ける	
slip of the tongue	失言，口を滑らせる	
abound in	であふれている，に富む	
exert oneself to	するために努力する	
equate A with B	AとBを等しくする	
wrestle with	取っ組み合う，取り組む	
be indebted to	に負債がある，恩義がある	
in the suburbs of	の郊外で	
inflict A on B	BにAを与える，負わせる	
to no purpose	何の目的もなく，無駄に	
have a flat tire	タイヤがパンクする	
all thumbs	手先が不器用な，ぶざまな	
in the mood for	したい気分である，する気になっている	
rest on	に基づく，に頼る	
complain of	を訴える，の不平を言う	
tear off	引きちぎる，脱ぎ捨てる	
snap out of	から素早く脱出する，抜け出す	
under fire	攻撃を受けて，批判を受けて	
halfway house	中盤，妥協点	
fall prey to	の餌食になる，犠牲になる	
trot out	持ち出す，言い出す	
from A to Z	最初から最後まで，終始	
shed light on	に光を放つ，当てる	
pass through	を通る，通り抜ける	
all told	全体で，結局	
take offense at	に怒る，腹を立てる	
not absolutely	絶対ではない，必ず，ではない	
bowl over	を打ち倒す，仰天させる	
far cry from	叫び声から遠い，からほど遠い	
lie on	責任がある，のしかかる，横になる	
take a beating	負ける，敗北する	
put emphasis on	に重点を置く，を重んじる	
be destitute of	に困窮する，を持っていない	
break into tears	涙が出る，泣き出す	
cast off	投げ捨てる，縄を解く	
go astray	行方不明になる，堕落する	
in all likelihood	おそらく，ほぼ確実に	
round and round	グルグルと，うろうろと	
in a bad temper	不機嫌に，機嫌の悪い	
stick up	上に突き出る，両手を挙げさせる	
think out	考え抜く，熟考する	
take root	根付く，定着する	
drink to	を祝って飲む，偲んで酒を飲む	
behind the scenes	舞台裏で，陰で	
put up at	に泊まる，宿泊する	
do A harm	Aに害を及ぼす，傷つける	
make allowance for	を大目に見る，を考慮に入れる	
be reckless of	を気に掛けない	
head over heels	真っ逆さまに，逆さまに	
bargain for	について交渉する，話し合う	
branch out	枝を出す，手を広げる	
carry off	運び去る，誘拐する	
sticking point	障害，行き詰り	
swallow up	飲み込む，使い尽くす	
"the lion&#x27;s share"	最大の分け前，大きすぎる分け前	
in disguise	変装した	
strip A of B	AからBを取り去る，奪う	
blow in	風が吹き込む，突然現れる	
an eye for an eye	目には目を，同じことをやり返す	
hail from	の出身である	
in a nutshell	一言で言えば，極めて簡単に言えば	
sleep in	寝床に入る，ゆっくり寝る	
"dos and don&#x27;ts"	規則集，注意事項	
no sweat	容易に，お安い御用で	
ups and downs	浮き沈み，上昇と下降	
barge in	入り込む，押しかける	
call down	下に向って叫ぶ，叱りつける	
word for word	一言一句，文字通りに	
catch a glimpse of	をちらっと見る，垣間見る	
buy up	全部買う，買収する	
set forth	説明する	
in anticipation of	を予期して，見込んで	
bestow A on B	BにAを授ける，費やす	
right out	退出時間を記録する，鳴り響く	
buck for	得ようと努める，求める	
to say the least	控えめに言っても	
for the good of	のために	
turn pale	青ざめる，血色が悪くなる	
out of the woods	森の外へ，困難を脱して	
odds and ends	がらくた，半端なもの	
set a precedent	先例を作る	
pertain to	に関係する，にふさわしい	
stumbling block	障害，障害物	
direct A to B	AにBへの道を教える，誘導する	
pick up the thread	再び続ける，再開する	
day in， day out	明けても暮れても，毎日毎日	
pan out	砂金が出る，成功する	
and the like	など，および同類の物	
up for grabs	容易に手に入る，誰が勝つかわからない	
shell out	支払う，大金を払う	
by the same token	同様に，さらに	
all ears	耳を傾ける，熱心に聴く	
boil over	沸騰してこぼれる，憤慨する	
be devoid of	を持っていない，に欠いている	
sleep over	外泊する，を見落とす	
back away	後退する，バックさせる	
capitalize on	に資本を投下する，を利用する	
keep abreast of	を常に把握している，通じている	
succumb to	に負ける，で死ぬ	
with open arms	両手を広げて	
down the drain	排水路に流されて，失われて	
without so much as doing	さえしないで	
hip to	に気づいている	
infringe on	侵害する	
tide over	乗り切る	
pick up the pieces	欠片を拾う，事態を修復する	
pay down	頭金として払う，即金で払う	
lay down	を横たえる	
to excess	過剰に，過度に	
rank and file	兵卒，一般人	
ill at ease	落ち着かない，不安な	
give way	道を譲る，くじける	
"in one&#x27;s presence"	目の前で	
run errands	使い走りをする，お使いをする	
in abundance	大量に，豊富に	
water down	水で薄める，和らげる	
fall in with	と知り合いになる，交際する	
ball up	混乱する，台無しにする	
at face value	額面通り，表面通りの価値で	
have off	取り外す，休暇を取る	
steal the show	話題をさらう，人気をさらう	
poke fun at	をからかう	
reproach A for B	BのことでAを非難する，咎める	
in token of	の証拠に，のしるしとして	
land A with B	AにBを引き受けさせる	
buy over	買収する，味方に抱き込む	
avail oneself of	を利用する	
gun for	を追い求める，必死になる	
and yet	それなのに，尚且つ	
speak ill of	の悪口を言う，を悪く言う	
wind up	巻き上げる，終わりにする	
boil down to	煮詰める，結局，になる	
ten to one	10対1で，じゅっちゅうはっく	
at close quarters	間近に，接近して	
vouch for	を保証する	
carve up	切り分ける，分割する	
in the concrete	具体的に	
rise and fall	上下する，起伏する	
go nuts	気がふれる，怒り狂う	
spring from	から生じる	
fish for	聞き出す，誘い出す	
be bound up with	と密接な関係のある，深く関係した	
get wet to the skin	ずぶ濡れになる，びしょ濡れになる	
take the plunge	思い切ってやる	
seldom if ever	めったに，しない	
in the affirmative	肯定の，賛成の	
keep at	を根気よく続ける，継続する	
flare up	急に燃え上がる，勃発する	
as a last resort	最後の手段として，切羽詰まって	
weed out	取り除く，引き抜く	
live out	生き延びる	
in radius	半径で	
keep down	身を低くする，大きな声を出さずにいる	
embroil in	に巻き込む	
by dint of	によって，の力で	
inquire after	の安否を尋ねる，を見舞う	
be keen to	やる気がある，乗り気になっている	
come away	から離れていく	
out in the cold	冷たくされて，無視されて	
with a vengeance	すさまじい勢いで，猛烈に	
drum up	呼び集める，募集する	
let on	漏らす，白状する	
rumor has it that	噂によると，らしい，との噂である	
pop up	飛び出す，出現する	
work off	徐々に取れる，減らす	
cast away	投げ捨てる，処分する	
sew up	縫合する，うまくまとめる	
